GGTCCGGACACCTCCCTAA -> GTCCGGACACCTCCCTAAA
ACCACCCGGTATGGGAAGC -> CCACCCGGTATGGGAAGCC
ACCTGGGGCCTCGTCTGTT -> CCTGGGGCCTCGTCTGTTT
CACAGTGGATCTGAATATC -> ACAGTGGATCTGAATATCT
ATAGGACTCAGTGTTTTCT -> TAGGACTCAGTGTTTTCTT
CGTGACCCAGGTAACCTGG -> GTGACCCAGGTAACCTGGG
ACTATCGTGCAAACAGAGG -> CTATCGTGCAAACAGAGGC
GTTGTCCTGAAAACGCCGT -> TTGTCCTGAAAACGCCGTG
AAAGGTATAGGACTCAGTG -> AAGGTATAGGACTCAGTGT
GCCTTGTTCGAAGTATAAA -> CCTTGTTCGAAGTATAAAC
GGTTAGCATAAGTGTAGGT -> GTTAGCATAAGTGTAGGTG
CAGACACGTATGGTTGCAA -> AGACACGTATGGTTGCAAT
GGGGACGTACTGGGTTCGT -> GGGACGTACTGGGTTCGTA
TTCCAGCAAAATCTCGAGT -> TCCAGCAAAATCTCGAGTG
CAGGCGATTTCTCACCCTA -> AGGCGATTTCTCACCCTAC
GGTTGCCCTCGATTGCATT -> GTTGCCCTCGATTGCATTC
GTATAGGACTCAGTGTTTT -> TATAGGACTCAGTGTTTTC
ACGTATGGTTGCAATCGAG -> CGTATGGTTGCAATCGAGT
ACCCTACTTACCTTGAGAC -> CCCTACTTACCTTGAGACC
TGTTCAACCATCCCGGCCA -> GTTCAACCATCCCGGCCAT
GCGATGCTCTTTGTCCCGA -> CGATGCTCTTTGTCCCGAC
CGCCGACTTCCAGCAAAAT -> GCCGACTTCCAGCAAAATC
CTCACTGGGGTCTTTCCTA -> TCACTGGGGTCTTTCCTAA
CGCTCCCCTACCCGCGACC -> GCTCCCCTACCCGCGACCC
GCCAAAGACGAGGCACTGA -> CCAAAGACGAGGCACTGAC
CAGTGGGAACCTTCCTCCA -> AGTGGGAACCTTCCTCCAC
GATTTGAACTCCTAGTTTC -> ATTTGAACTCCTAGTTTCA
TAGGCTCATCATCTCGAGT -> AGGCTCATCATCTCGAGTG
GATGAGACAGGCGATTTCT -> ATGAGACAGGCGATTTCTC
GCCACCAGATACGGTAGCC -> CCACCAGATACGGTAGCCA
CTCATGCTTTGACTCATCT -> TCATGCTTTGACTCATCTA
GACACCTCCCCGGAGTTGC -> ACACCTCCCCGGAGTTGCA
CAGACCTCCACCATTGGCG -> AGACCTCCACCATTGGCGA
CTACCCGCGACCCCAGTAT -> TACCCGCGACCCCAGTATT
TACGCGGTCCGGACACCTC -> ACGCGGTCCGGACACCTCC
CTAATGTTTCGCGGTCCGG -> TAATGTTTCGCGGTCCGGA
AACACGTGTGCTGCAACAC -> ACACGTGTGCTGCAACACT
AGCGTAGCACGATGGTAAC -> GCGTAGCACGATGGTAACC
CTATTTTTTGGCATGTTAA -> TATTTTTTGGCATGTTAAG
GGAGCGGAGATGACGTTAG -> GAGCGGAGATGACGTTAGG
TCTCTCCGACGGCTTGTGA -> CTCTCCGACGGCTTGTGAT
GCAATCGAGTACTACGTTT -> CAATCGAGTACTACGTTTA
GTTACCACCCGGTATGGGA -> TTACCACCCGGTATGGGAA
AACTAAGTGTATAAGTGGG -> ACTAAGTGTATAAGTGGGC
CTATCGTGCAAACAGAGGC -> TATCGTGCAAACAGAGGCG
CATAATCGGCAGGATTGGA -> ATAATCGGCAGGATTGGAC
GGGTCGTCCTTTAATACTC -> GGTCGTCCTTTAATACTCT
GATTGGCTGGACGGAACAG -> ATTGGCTGGACGGAACAGT
ACTACTGCCGATTTCCTGT -> CTACTGCCGATTTCCTGTG
GAGTAAGTTTTCCCGATGG -> AGTAAGTTTTCCCGATGGA
CACCTCCTATTCACTAATG -> ACCTCCTATTCACTAATGT
GCTATTTGTTCGTTACAAG -> CTATTTGTTCGTTACAAGA
ACCAGCCAGACACGTATGG -> CCAGCCAGACACGTATGGT
AGTATTAGCCGTCTTGGAA -> GTATTAGCCGTCTTGGAAG
AGCTCCGCTAGCGGAACAG -> GCTCCGCTAGCGGAACAGA
GAATACGGTTAGCATAAGT -> AATACGGTTAGCATAAGTG
ATTGTACGTGAAGGCGCGG -> TTGTACGTGAAGGCGCGGT
AGTAAGCTGGTAGAATACG -> GTAAGCTGGTAGAATACGG
ACACCGTGTGCCACGTGAC -> CACCGTGTGCCACGTGACC
CGTAGCCGACCAGCCAGAC -> GTAGCCGACCAGCCAGACA
TACTCTCTTCCGAGCTTAA -> ACTCTCTTCCGAGCTTAAG
GCTAAGACATCGTATAGGT -> CTAAGACATCGTATAGGTA
TGGACGGAACAGTTTCCAC -> GGACGGAACAGTTTCCACG
CACCATTGGCGATGCTCTT -> ACCATTGGCGATGCTCTTT
GGGAGGTGAATGCACCCGT -> GGAGGTGAATGCACCCGTT
CCACAGTGGATCTGAATAT -> CACAGTGGATCTGAATATC
CGAGGTTGTCCTGAAAACG -> GAGGTTGTCCTGAAAACGC
TACGGGAGGTGAATGCACC -> ACGGGAGGTGAATGCACCC
CTTAAGGGATAGCAAGCGT -> TTAAGGGATAGCAAGCGTA
TCGAGTGCCCATCCCATGG -> CGAGTGCCCATCCCATGGC
GCGGTCCGGACACCTCCCC -> CGGTCCGGACACCTCCCCT, CGGTCCGGACACCTCCCCG
CTTCCACAGACTTTTACAT -> TTCCACAGACTTTTACATA
GTTCATCCTTAACCCAAAG -> TTCATCCTTAACCCAAAGG
TACCTTGAGACCTGTTGAA -> ACCTTGAGACCTGTTGAAC
AATAGGCGCACGCTCCCCT -> ATAGGCGCACGCTCCCCTA
TCCTATTCACTAATGTTTC -> CCTATTCACTAATGTTTCG
TCCCCTACCCGCGACCCCA -> CCCCTACCCGCGACCCCAG
TGGGACACGCACACACCGT -> GGGACACGCACACACCGTG
GACCGCATAAACCACACAG -> ACCGCATAAACCACACAGT
ACGGAGGAGGCTTCCTTAA -> CGGAGGAGGCTTCCTTAAT
GTTGTTATGTTTGGTCAGA -> TTGTTATGTTTGGTCAGAC
AGGGTCTTCCCGCTGTACG -> GGGTCTTCCCGCTGTACGG
GATGTGTGGTTTAGACACT -> ATGTGTGGTTTAGACACTA
GCAAGCGTAGCACGATGGT -> CAAGCGTAGCACGATGGTA
TCTTTGGTGGGAAGGTTAT -> CTTTGGTGGGAAGGTTATG
AAGAGTCGCGTTTCCGTAA -> AGAGTCGCGTTTCCGTAAG
CCTACCCGCGACCCCAGTA -> CTACCCGCGACCCCAGTAT
AGTTTCCACGTAATATACA -> GTTTCCACGTAATATACAA
AGTGAGCGCTCGTTGTCAA -> GTGAGCGCTCGTTGTCAAC
TGTAACCCGTGACGGTCGC -> GTAACCCGTGACGGTCGCC
TAAATATTAGATGCTTAAT -> AAATATTAGATGCTTAATA
TTATGAATAAATACTAGTA -> TATGAATAAATACTAGTAT
AAAGTCATGCAACTCAGAG -> AAGTCATGCAACTCAGAGG
GTAGGCTCATCATCTCGAG -> TAGGCTCATCATCTCGAGT
ATAAATACTAGTATTAGCC -> TAAATACTAGTATTAGCCG
ATCCCATGGCGACAATCAC -> TCCCATGGCGACAATCACT
TTAGCCGTCTTGGAAGCCT -> TAGCCGTCTTGGAAGCCTA
TCCGAGCTTAAGGGATAGC -> CCGAGCTTAAGGGATAGCA
GAGCGGAGATGACGTTAGG -> AGCGGAGATGACGTTAGGA
GCCCTCGATTGCATTCAGG -> CCCTCGATTGCATTCAGGT
CTTAACCCAAAGGTATAGG -> TTAACCCAAAGGTATAGGA
TAGGGACTCGCCTGGTCGA -> AGGGACTCGCCTGGTCGAC
ACACGGCTGAGGGGACGTA -> CACGGCTGAGGGGACGTAC
CTCCCATACCGCCTCGAGT -> TCCCATACCGCCTCGAGTA
TGGGGCAGAGTAAGTTTTC -> GGGGCAGAGTAAGTTTTCC
TTACCACCCGGTATGGGAA -> TACCACCCGGTATGGGAAG
TATTGTTCTAGTTTCACCT -> ATTGTTCTAGTTTCACCTC
GAAGGTTATGTACTAGGTT -> AAGGTTATGTACTAGGTTC
GAGTATGGCGGTTGCCCTC -> AGTATGGCGGTTGCCCTCG
TCCTATTTCGAAATTCAAC -> CCTATTTCGAAATTCAACG
TGCTGCAACACTATCGTGC -> GCTGCAACACTATCGTGCA
GTAGCACGATGGTAACCTC -> TAGCACGATGGTAACCTCT
TTGTCAACAAAGTCCAACG -> TGTCAACAAAGTCCAACGC
GCCTTTCCGCGAGCCTTGT -> CCTTTCCGCGAGCCTTGTT
GGTTCGTACAGTTGGCTTA -> GTTCGTACAGTTGGCTTAA
AACTCCTAGTTTCACCTCC -> ACTCCTAGTTTCACCTCCT
TGTACGGGAGGTGAATGCA -> GTACGGGAGGTGAATGCAC
GGGATAGCAAGCGTAGCAC -> GGATAGCAAGCGTAGCACG
GGATCGTCCCAACCGTGCC -> GATCGTCCCAACCGTGCCG
AGGGCTAAGACATCGTATA -> GGGCTAAGACATCGTATAG
TGGGGCCTCGTCTGTTTGT -> GGGGCCTCGTCTGTTTGTG
CTTGAGACCTGTTGAACAC -> TTGAGACCTGTTGAACACG
GTCTTGGAAGCCTACACGG -> TCTTGGAAGCCTACACGGC
CCGTAAGCCGAGCCTCCGC -> CGTAAGCCGAGCCTCCGCT
ACGGTGGATCGTCCCAACC -> CGGTGGATCGTCCCAACCG
CGTGGAGCGGAGATGACGT -> GTGGAGCGGAGATGACGTT
CGCACGTAGTTGATGAGCG -> GCACGTAGTTGATGAGCGT
CCCTCGCCCAAATTTGGGC -> CCTCGCCCAAATTTGGGCA
CGATGGACGGAGGAGGCTT -> GATGGACGGAGGAGGCTTC
CAATCACTGATTACGCACG -> AATCACTGATTACGCACGT
GGGGTCTTTCCTAATGGGA -> GGGTCTTTCCTAATGGGAG
GTACTACGTTTAACAATCC -> TACTACGTTTAACAATCCC
TCGATATGTTGAGCGCCAG -> CGATATGTTGAGCGCCAGG
CTTCCTTAATTGTGTAACC -> TTCCTTAATTGTGTAACCC
CCTGGGGCCTCGTCTGTTT -> CTGGGGCCTCGTCTGTTTG
TCCTAGTTTCACCTCCTAT -> CCTAGTTTCACCTCCTATT
TTGGTTATGAATAAATACT -> TGGTTATGAATAAATACTA
CCCTAAGTTCTGGCTCATG -> CCTAAGTTCTGGCTCATGC
ATGTACTAGGTTCGCCAAA -> TGTACTAGGTTCGCCAAAG
TTTTCCCGATGGACGGAGG -> TTTCCCGATGGACGGAGGA
TTCCCTCTAGGATTTTGCG -> TCCCTCTAGGATTTTGCGT
GATTTGCGTTCGGGGCAGT -> ATTTGCGTTCGGGGCAGTC
ACGGCTGAGGGGACGTACT -> CGGCTGAGGGGACGTACTG
GTCAGACCTCCACCATTGG -> TCAGACCTCCACCATTGGC
CCATCCCATGGCGACAATC -> CATCCCATGGCGACAATCA
TTCCACAGACTTTTACATA -> TCCACAGACTTTTACATAG
TTCGTACAGTTGGCTTAAC -> TCGTACAGTTGGCTTAACG
TATGTACTAGGTTCGCCAA -> ATGTACTAGGTTCGCCAAA
GTGGTTTAGACACTACAGT -> TGGTTTAGACACTACAGTA
AAGTTCCGATTCCAAAGTC -> AGTTCCGATTCCAAAGTCA
TGGAGCGGAGATGACGTTA -> GGAGCGGAGATGACGTTAG
CTCTAGGATTTTGCGTGTT -> TCTAGGATTTTGCGTGTTC
CTGGGTTCGTACAGTTGGC -> TGGGTTCGTACAGTTGGCT
TTTTCCACGAGTTATTGTT -> TTTCCACGAGTTATTGTTC
GGTCCGGACACCTCCCCTC -> GTCCGGACACCTCCCCTCA
GGCTACTACTGCCGATTTC -> GCTACTACTGCCGATTTCC
AAGGTTATGTACTAGGTTC -> AGGTTATGTACTAGGTTCG
CTATTATTTACGAGGTTGT -> TATTATTTACGAGGTTGTC
GTACTAGGTTCGCCAAAGA -> TACTAGGTTCGCCAAAGAC
AATACTAGTATTAGCCGTC -> ATACTAGTATTAGCCGTCT
AGAGAAGTGAGCGCTCGTT -> GAGAAGTGAGCGCTCGTTG
GTGGGAACCTTCCTCCACA -> TGGGAACCTTCCTCCACAG
TTGGTCAGACGCCATCTAT -> TGGTCAGACGCCATCTATC
TATTAGATGCTTAATAGGC -> ATTAGATGCTTAATAGGCG
ACTCAGAGGCATAGAGTAT -> CTCAGAGGCATAGAGTATA
GACTCGCCTGGTCGACCGG -> ACTCGCCTGGTCGACCGGC
GCCTGCGTCCAATCGGAGG -> CCTGCGTCCAATCGGAGGA
CGCCGTGTGCTTCTCCGAA -> GCCGTGTGCTTCTCCGAAA
TAGCGGAACAGATGTAAAC -> AGCGGAACAGATGTAAACG
TCACCTCCTATTGTACGTG -> CACCTCCTATTGTACGTGA
TGCAACACTATCGTGCAAA -> GCAACACTATCGTGCAAAC
AGTGTAGGTGAGGACATTC -> GTGTAGGTGAGGACATTCT
ACGGTAGCCAAGTTCCGAT -> CGGTAGCCAAGTTCCGATT
GCAGGATTGGACTAATAAG -> CAGGATTGGACTAATAAGA
TGGTAACCTCTCTCCGACG -> GGTAACCTCTCTCCGACGG
TGTTGAACACGTGTGCTGC -> GTTGAACACGTGTGCTGCA
TTTCACCTCCTATTTCGAA -> TTCACCTCCTATTTCGAAA
CCCTATTATTTACGAGGTT -> CCTATTATTTACGAGGTTG
ATCTATCGTAGGCTCATCA -> TCTATCGTAGGCTCATCAT
AGTTGCAGGTTCTCCCATC -> GTTGCAGGTTCTCCCATCG
AGGGATAGCAAGCGTAGCA -> GGGATAGCAAGCGTAGCAC
GGTTTAGACACTACAGTAT -> GTTTAGACACTACAGTATA
CAACCATCCGCAGAATTCT -> AACCATCCGCAGAATTCTT
AGCCAGACACGTATGGTTG -> GCCAGACACGTATGGTTGC
CGAGCCTTGTTCGAAGTAT -> GAGCCTTGTTCGAAGTATA
AGTGCCCATCCCATGGCGA -> GTGCCCATCCCATGGCGAC
GTCATGCAACTCAGAGGCA -> TCATGCAACTCAGAGGCAT
ATCGTCCCAACCGTGCCGG -> TCGTCCCAACCGTGCCGGG
TTCTCCCATCGGTTCATCC -> TCTCCCATCGGTTCATCCT
AAATCTCGAGTGCCCATCC -> AATCTCGAGTGCCCATCCC
TGACTACGGTGGATCGTCC -> GACTACGGTGGATCGTCCC
CTCGAGTAGATATCGAGCT -> TCGAGTAGATATCGAGCTT
CCTCCCCTCATAATCGGCA -> CTCCCCTCATAATCGGCAG
TAAGTGTATAAGTGGGCCT -> AAGTGTATAAGTGGGCCTG
GGTACGTCAGGGCTAAGAC -> GTACGTCAGGGCTAAGACA
ACAAGTTACAATCGGGCAA -> CAAGTTACAATCGGGCAAC
CCAAATTTGGGCAATGCGG -> CAAATTTGGGCAATGCGGG
CATAGGCTCTCGATTTGCG -> ATAGGCTCTCGATTTGCGT
GACTACGGTGGATCGTCCC -> ACTACGGTGGATCGTCCCA
GGGACTCGCCTGGTCGACC -> GGACTCGCCTGGTCGACCG
CGTGAAGGCGCGGTCCGGA -> GTGAAGGCGCGGTCCGGAC
GAGCCTTGTTCGAAGTATA -> AGCCTTGTTCGAAGTATAA
CGCGGTCCGGACACCTCCC -> GCGGTCCGGACACCTCCCC, GCGGTCCGGACACCTCCCT, GCGGTCCGGACACCTCCCT, GCGGTCCGGACACCTCCCC
AGTTTCACCTCCTATTCAC -> GTTTCACCTCCTATTCACT
TAGATATCGAGCTTATCGC -> AGATATCGAGCTTATCGCG
CACGTATGGTTGCAATCGA -> ACGTATGGTTGCAATCGAG
TCGCGGTCCGGACACCTCC -> CGCGGTCCGGACACCTCCC
ACACGTATGGTTGCAATCG -> CACGTATGGTTGCAATCGA
TTACGAGGTTGTCCTGAAA -> TACGAGGTTGTCCTGAAAA
TCGTGTTACCACCCGGTAT -> CGTGTTACCACCCGGTATG
TACTAGTATTAGCCGTCTT -> ACTAGTATTAGCCGTCTTG
ATGTTTGGTCAGACGCCAT -> TGTTTGGTCAGACGCCATC
GTACTGGGTTCGTACAGTT -> TACTGGGTTCGTACAGTTG
AGGCTCATCATCTCGAGTG -> GGCTCATCATCTCGAGTGG
CAGTGGATCTGAATATCTA -> AGTGGATCTGAATATCTAA
CGGGAGGTGAATGCACCCG -> GGGAGGTGAATGCACCCGT
TTCGCGGTCCGGACACCTC -> TCGCGGTCCGGACACCTCC
GAAAACGCCGTGTGCTTCT -> AAAACGCCGTGTGCTTCTC
TCCTATTATCCTGCTTTAC -> CCTATTATCCTGCTTTACG
CGTAATATACAACAGGGTC -> GTAATATACAACAGGGTCT
TCCGGACACCTCCCCTCAT -> CCGGACACCTCCCCTCATA
TGCTTAATAGGCGCACGCT -> GCTTAATAGGCGCACGCTC
CCAATCGGAGGACCGTATC -> CAATCGGAGGACCGTATCG
CTAGTTTCACCTCCTATTA -> TAGTTTCACCTCCTATTAT
GGTTATGAATAAATACTAG -> GTTATGAATAAATACTAGT
TTGAGACCTGTTGAACACG -> TGAGACCTGTTGAACACGT
TCTCGAGTGCCCATCCCAT -> CTCGAGTGCCCATCCCATG
GGGTCTTTCCTAATGGGAG -> GGTCTTTCCTAATGGGAGG
TATTGTACGTGAAGGCGCG -> ATTGTACGTGAAGGCGCGG
GGTATAGGGACTCGCCTGG -> GTATAGGGACTCGCCTGGT
TTTGGGCAATGCGGGTTCG -> TTGGGCAATGCGGGTTCGC
CATCCTTAACCCAAAGGTA -> ATCCTTAACCCAAAGGTAT
CACGAGTTATTGTTCTAGT -> ACGAGTTATTGTTCTAGTT
GCCGGGTCGTCCTTTAATA -> CCGGGTCGTCCTTTAATAC
GTATATGCGACTTAATTTG -> TATATGCGACTTAATTTGA
AAAATAATCGGATTTGAAC -> AAATAATCGGATTTGAACT
TCTTAAGTAAGCTGGTAGA -> CTTAAGTAAGCTGGTAGAA
CCTTCCTCCACAGTGGATC -> CTTCCTCCACAGTGGATCT
GTTACAAGAGTCGCGTTTC -> TTACAAGAGTCGCGTTTCC
GAGGGACCGCATAAACCAC -> AGGGACCGCATAAACCACA
GGCGCACGCTCCCCTACCC -> GCGCACGCTCCCCTACCCG
TCCTGAAAACGCCGTGTGC -> CCTGAAAACGCCGTGTGCT
TGACCCAGGTAACCTGGGG -> GACCCAGGTAACCTGGGGC
ACCATTGGCGATGCTCTTT -> CCATTGGCGATGCTCTTTG
GTAAGCTGGTAGAATACGG -> TAAGCTGGTAGAATACGGT
AAGTGAGCGCTCGTTGTCA -> AGTGAGCGCTCGTTGTCAA
TCCCATCGGTTCATCCTTA -> CCCATCGGTTCATCCTTAA
TTGCCGTGGAGCGGAGATG -> TGCCGTGGAGCGGAGATGA
GCGTGACTACGGTGGATCG -> CGTGACTACGGTGGATCGT
TTGGAAGCCTACACGGCTG -> TGGAAGCCTACACGGCTGA
TGGGGTCTTTCCTAATGGG -> GGGGTCTTTCCTAATGGGA
ACCGTGTGCCACGTGACCC -> CCGTGTGCCACGTGACCCA
CAACACTAGTTTCACCTCC -> AACACTAGTTTCACCTCCT
CAAAGTCATGCAACTCAGA -> AAAGTCATGCAACTCAGAG
GTCCGGACACCTCCCCGGA -> TCCGGACACCTCCCCGGAG
CCACGTGACCCAGGTAACC -> CACGTGACCCAGGTAACCT
GATTACGCACGTAGTTGAT -> ATTACGCACGTAGTTGATG
GACGGAGGAGGCTTCCTTA -> ACGGAGGAGGCTTCCTTAA
GCCCAAATTTGGGCAATGC -> CCCAAATTTGGGCAATGCG
CGTCCAATCGGAGGACCGT -> GTCCAATCGGAGGACCGTA
TCCCGATGGACGGAGGAGG -> CCCGATGGACGGAGGAGGC
ACCTCCCTATTATTTACGA -> CCTCCCTATTATTTACGAG
TAACCTGGGGCCTCGTCTG -> AACCTGGGGCCTCGTCTGT
ATCTCGTCAGACCTCCACC -> TCTCGTCAGACCTCCACCA
TGGGCAATGCGGGTTCGCT -> GGGCAATGCGGGTTCGCTG
AAATACTAGTATTAGCCGT -> AATACTAGTATTAGCCGTC
TTGTTCTAGTTTCACCTCC -> TGTTCTAGTTTCACCTCCT
GGTCGCCCTCGCCCAAATT -> GTCGCCCTCGCCCAAATTT
ACAGGCGATTTCTCACCCT -> CAGGCGATTTCTCACCCTA
ACAATCCCGTTTTCCACGA -> CAATCCCGTTTTCCACGAG
ATGTAAACGGACGAGCACA -> TGTAAACGGACGAGCACAA
GACAGCTCCGCTAGCGGAA -> ACAGCTCCGCTAGCGGAAC
TTTTTTGGCATGTTAAGAA -> TTTTTGGCATGTTAAGAAA
ATGGGACACGCACACACCG -> TGGGACACGCACACACCGT
ACCTGTTGAACACGTGTGC -> CCTGTTGAACACGTGTGCT
GTTGAACACGTGTGCTGCA -> TTGAACACGTGTGCTGCAA
GCGTTTCCGTAAGCCGAGC -> CGTTTCCGTAAGCCGAGCC
GAAGCCTACACGGCTGAGG -> AAGCCTACACGGCTGAGGG
TTAACGTAATGGGACACGC -> TAACGTAATGGGACACGCA
CCCCTCATAATCGGCAGGA -> CCCTCATAATCGGCAGGAT
GCGACAATCACTGATTACG -> CGACAATCACTGATTACGC
TAGCCCTAAGTTCTGGCTC -> AGCCCTAAGTTCTGGCTCA
TTAAGAAACCTTCCACAGA -> TAAGAAACCTTCCACAGAC
ATAAACGGGCCGGGACTTG -> TAAACGGGCCGGGACTTGG
TCGTTGTCAACAAAGTCCA -> CGTTGTCAACAAAGTCCAA
TGTAGGTGAGGACATTCTT -> GTAGGTGAGGACATTCTTT
GGCTCATCATCTCGAGTGG -> GCTCATCATCTCGAGTGGG
CCATAATGTACTTATCGTC -> CATAATGTACTTATCGTCC
GAATTCTTAAGTAAGCTGG -> AATTCTTAAGTAAGCTGGT
ACCTCCCCTCATAATCGGC -> CCTCCCCTCATAATCGGCA
ATTAGCCGTCTTGGAAGCC -> TTAGCCGTCTTGGAAGCCT
GGGATGTGTGGTTTAGACA -> GGATGTGTGGTTTAGACAC
CGGTCCGGACACCTCCCCG -> GGTCCGGACACCTCCCCGG
TCAGACGCCATCTATCGTA -> CAGACGCCATCTATCGTAG
GCAGAGTAAGTTTTCCCGA -> CAGAGTAAGTTTTCCCGAT
CGCCCAAATTTGGGCAATG -> GCCCAAATTTGGGCAATGC
AAGTGGGCCTGCGTCCAAT -> AGTGGGCCTGCGTCCAATC
CGTGTGCTGCAACACTATC -> GTGTGCTGCAACACTATCG
TTTTCTTCCCTCTAGGATT -> TTTCTTCCCTCTAGGATTT
AAACAGAGGCGTAGCCGAC -> AACAGAGGCGTAGCCGACC
GGAAGGTTATGTACTAGGT -> GAAGGTTATGTACTAGGTT
GTTTCCGTAAGCCGAGCCT -> TTTCCGTAAGCCGAGCCTC
TTTCACCTCCTATTCACTA -> TTCACCTCCTATTCACTAA
GTTGCCCTCGATTGCATTC -> TTGCCCTCGATTGCATTCA
GCTTAATAGGCGCACGCTC -> CTTAATAGGCGCACGCTCC
GAGTCGCGTTTCCGTAAGC -> AGTCGCGTTTCCGTAAGCC
TGAGACCTGTTGAACACGT -> GAGACCTGTTGAACACGTG
GAGCGCTCGTTGTCAACAA -> AGCGCTCGTTGTCAACAAA
CGGGGCAGTCTCATGGGGC -> GGGGCAGTCTCATGGGGCA
GTGTATAAGTGGGCCTGCG -> TGTATAAGTGGGCCTGCGT
GTCGTCCTTTAATACTCTC -> TCGTCCTTTAATACTCTCT
TGTGTAACCCGTGACGGTC -> GTGTAACCCGTGACGGTCG
TTGCTATTTGTTCGTTACA -> TGCTATTTGTTCGTTACAA
GAGCAAGAGAAGTGAGCGC -> AGCAAGAGAAGTGAGCGCT
ATATGTTGAGCGCCAGGTC -> TATGTTGAGCGCCAGGTCT
ACCTCACTGGGGTCTTTCC -> CCTCACTGGGGTCTTTCCT
TAAGCTGGTAGAATACGGT -> AAGCTGGTAGAATACGGTT
TCAGGGCTAAGACATCGTA -> CAGGGCTAAGACATCGTAT
GACCCAGGTAACCTGGGGC -> ACCCAGGTAACCTGGGGCC
CAGTTTCCACGTAATATAC -> AGTTTCCACGTAATATACA
TGACGTTAGGACCAACCAT -> GACGTTAGGACCAACCATC
TAACCTCTCTCCGACGGCT -> AACCTCTCTCCGACGGCTT
GTGCCGGGTCGTCCTTTAA -> TGCCGGGTCGTCCTTTAAT
CCCTACCCGCGACCCCAGT -> CCTACCCGCGACCCCAGTA
TCCACGTAATATACAACAG -> CCACGTAATATACAACAGG
TCCACAGACTTTTACATAG -> CCACAGACTTTTACATAGA
TTTCACCTCCTATTATCCT -> TTCACCTCCTATTATCCTG
GAGCCTCCGCTAGTTTCAC -> AGCCTCCGCTAGTTTCACC
TGCGGGTTCGCTGAGGGAC -> GCGGGTTCGCTGAGGGACC
ACGTCAGGGCTAAGACATC -> CGTCAGGGCTAAGACATCG
CAAGCGTAGCACGATGGTA -> AAGCGTAGCACGATGGTAA
TCCTTAATTGTGTAACCCG -> CCTTAATTGTGTAACCCGT
CCCCGAGCAAGAGAAGTGA -> CCCGAGCAAGAGAAGTGAG
GGCTCATGCTTTGACTCAT -> GCTCATGCTTTGACTCATC
GGCTGAGGGGACGTACTGG -> GCTGAGGGGACGTACTGGG
AGTCATGCAACTCAGAGGC -> GTCATGCAACTCAGAGGCA
CCGGGTCGTCCTTTAATAC -> CGGGTCGTCCTTTAATACT
CAAGAGAAGTGAGCGCTCG -> AAGAGAAGTGAGCGCTCGT
GCCTACACGGCTGAGGGGA -> CCTACACGGCTGAGGGGAC
ATTTGCGTTCGGGGCAGTC -> TTTGCGTTCGGGGCAGTCT
CATCTATCGTAGGCTCATC -> ATCTATCGTAGGCTCATCA
GCTAGATTACGACTGATAT -> CTAGATTACGACTGATATT
AATTCAACGCGGTCCGGAC -> ATTCAACGCGGTCCGGACA
GACTCAGTGTTTTCTTCCC -> ACTCAGTGTTTTCTTCCCT
CGGAACAGTTTCCACGTAA -> GGAACAGTTTCCACGTAAT
CCAAAGGTATAGGACTCAG -> CAAAGGTATAGGACTCAGT
TCTGAATATCTAAATCGTG -> CTGAATATCTAAATCGTGT
GTGTGCTTCTCCGAAAAAT -> TGTGCTTCTCCGAAAAATA
TGGCGTGACTACGGTGGAT -> GGCGTGACTACGGTGGATC
GTGTAGGTGAGGACATTCT -> TGTAGGTGAGGACATTCTT
CGAGTACTACGTTTAACAA -> GAGTACTACGTTTAACAAT
ACGTAATGGGACACGCACA -> CGTAATGGGACACGCACAC
AGGCGCACGCTCCCCTACC -> GGCGCACGCTCCCCTACCC
AGTGGGATGTGTGGTTTAG -> GTGGGATGTGTGGTTTAGA
TTCCTGTGCATAGGCTCTC -> TCCTGTGCATAGGCTCTCG
GTATAGGGACTCGCCTGGT -> TATAGGGACTCGCCTGGTC
ACGATGGTAACCTCTCTCC -> CGATGGTAACCTCTCTCCG
AGTGGGCCTGCGTCCAATC -> GTGGGCCTGCGTCCAATCG
GCCCTCGCCCAAATTTGGG -> CCCTCGCCCAAATTTGGGC
AGTTGATGAGCGTCCGGGC -> GTTGATGAGCGTCCGGGCC
TAGGACTCAGTGTTTTCTT -> AGGACTCAGTGTTTTCTTC
TGTGCTTCTCCGAAAAATA -> GTGCTTCTCCGAAAAATAA
TCCCCTCATAATCGGCAGG -> CCCCTCATAATCGGCAGGA
GCTGTGGCGTGACTACGGT -> CTGTGGCGTGACTACGGTG
CGACTTAATTTGACCTCCC -> GACTTAATTTGACCTCCCA
TCATGCTTTGACTCATCTA -> CATGCTTTGACTCATCTAG
GTCGCGTTTCCGTAAGCCG -> TCGCGTTTCCGTAAGCCGA
TAGAGTATATGCGACTTAA -> AGAGTATATGCGACTTAAT
CTCTCTTCCGAGCTTAAGG -> TCTCTTCCGAGCTTAAGGG
GACGGAACAGTTTCCACGT -> ACGGAACAGTTTCCACGTA
CCGTGCCGGGTCGTCCTTT -> CGTGCCGGGTCGTCCTTTA
GTGGAGCGGAGATGACGTT -> TGGAGCGGAGATGACGTTA
TAACCCGTGACGGTCGCCC -> AACCCGTGACGGTCGCCCT
AGACTTTTACATAGATCTC -> GACTTTTACATAGATCTCG
TATTTTTTGGCATGTTAAG -> ATTTTTTGGCATGTTAAGA
TAAATCGTGTTACCACCCG -> AAATCGTGTTACCACCCGG
AGAAAAACACCTCACTGGG -> GAAAAACACCTCACTGGGG
CGTATGGTTGCAATCGAGT -> GTATGGTTGCAATCGAGTA
TCGTCCTTTAATACTCTCT -> CGTCCTTTAATACTCTCTT
CACCTCCTATTATCCTGCT -> ACCTCCTATTATCCTGCTT
TTTGCTATTTGTTCGTTAC -> TTGCTATTTGTTCGTTACA
TATAGGTATAGGGACTCGC -> ATAGGTATAGGGACTCGCC
CGTCCTTTAATACTCTCTT -> GTCCTTTAATACTCTCTTC
TTATTTACGAGGTTGTCCT -> TATTTACGAGGTTGTCCTG
CACCCGGTATGGGAAGCCA -> ACCCGGTATGGGAAGCCAA
TCTTCCGAGCTTAAGGGAT -> CTTCCGAGCTTAAGGGATA
CACCAGATACGGTAGCCAA -> ACCAGATACGGTAGCCAAG
TAAACGGACGAGCACAAGT -> AAACGGACGAGCACAAGTT
CGACTGATATTTGCTATTT -> GACTGATATTTGCTATTTG
ACGTGAAGGCGCGGTCCGG -> CGTGAAGGCGCGGTCCGGA
GTGACGGTCGCCCTCGCCC -> TGACGGTCGCCCTCGCCCA
CTCCGCTAGTTTCACCTCC -> TCCGCTAGTTTCACCTCCT
TTGTCCTGAAAACGCCGTG -> TGTCCTGAAAACGCCGTGT
GCGACCCCAGTATTGGTTA -> CGACCCCAGTATTGGTTAT
CAGAGGCGTAGCCGACCAG -> AGAGGCGTAGCCGACCAGC
CATAAACCACACAGTGGGA -> ATAAACCACACAGTGGGAA
GTATAAACGGGCCGGGACT -> TATAAACGGGCCGGGACTT
CGATTCCAAAGTCATGCAA -> GATTCCAAAGTCATGCAAC
ATCGGGCAACACTAGTTTC -> TCGGGCAACACTAGTTTCA
ATCGCGAGTCGCGGTATTG -> TCGCGAGTCGCGGTATTGC
TCGCTGAGGGACCGCATAA -> CGCTGAGGGACCGCATAAA
CCGCTAGTTTCACCTCCTA -> CGCTAGTTTCACCTCCTAT
CTTCCGAGCTTAAGGGATA -> TTCCGAGCTTAAGGGATAG
CGACCAGCCAGACACGTAT -> GACCAGCCAGACACGTATG
TTTCACCTCCTATTGTACG -> TTCACCTCCTATTGTACGT
ATACGGTTAGCATAAGTGT -> TACGGTTAGCATAAGTGTA
CCGCATAAACCACACAGTG -> CGCATAAACCACACAGTGG
TCGTGCAAACAGAGGCGTA -> CGTGCAAACAGAGGCGTAG
GTGGGAAGGTTATGTACTA -> TGGGAAGGTTATGTACTAG
ACCCCAGTATTGGTTATGA -> CCCCAGTATTGGTTATGAA
GTGACCCAGGTAACCTGGG -> TGACCCAGGTAACCTGGGG
CCACACAGTGGGAACCTTC -> CACACAGTGGGAACCTTCC
CCAGATACGGTAGCCAAGT -> CAGATACGGTAGCCAAGTT
TGTGGCGTGACTACGGTGG -> GTGGCGTGACTACGGTGGA
TCCCATGGCGACAATCACT -> CCCATGGCGACAATCACTG
TGTAAACGGACGAGCACAA -> GTAAACGGACGAGCACAAG
CCGCCTCGAGTAGATATCG -> CGCCTCGAGTAGATATCGA
ATATGCGACTTAATTTGAC -> TATGCGACTTAATTTGACC
AACGCCTTTCCGCGAGCCT -> ACGCCTTTCCGCGAGCCTT
ATGGTAACCTCTCTCCGAC -> TGGTAACCTCTCTCCGACG
TGCTATTTGTTCGTTACAA -> GCTATTTGTTCGTTACAAG
TCAGACCTCCACCATTGGC -> CAGACCTCCACCATTGGCG
ATGCAACTCAGAGGCATAG -> TGCAACTCAGAGGCATAGA
TCTAGGCGTCTATTTTTTG -> CTAGGCGTCTATTTTTTGG
ACGGTTAGCATAAGTGTAG -> CGGTTAGCATAAGTGTAGG
AGATGACGTTAGGACCAAC -> GATGACGTTAGGACCAACC
AGACACGTATGGTTGCAAT -> GACACGTATGGTTGCAATC
ATCGGCAGGATTGGACTAA -> TCGGCAGGATTGGACTAAT
GGTATGGGAAGCCAAACTA -> GTATGGGAAGCCAAACTAA
TTGGACTAATAAGAATTTC -> TGGACTAATAAGAATTTCA
GAGCGCCAGGTCTCGCCGA -> AGCGCCAGGTCTCGCCGAC
GTATCGGCTAGATTACGAC -> TATCGGCTAGATTACGACT
TGCAAACAGAGGCGTAGCC -> GCAAACAGAGGCGTAGCCG
GCGTAGCACGATGGTAACC -> CGTAGCACGATGGTAACCT
CCTTAACCCAAAGGTATAG -> CTTAACCCAAAGGTATAGG
ACCTCCCATACCGCCTCGA -> CCTCCCATACCGCCTCGAG
ATAGGTATAGGGACTCGCC -> TAGGTATAGGGACTCGCCT
TTGTGTAACCCGTGACGGT -> TGTGTAACCCGTGACGGTC
CGGTGGATCGTCCCAACCG -> GGTGGATCGTCCCAACCGT
AATATTAGATGCTTAATAG -> ATATTAGATGCTTAATAGG
AGACCTGTTGAACACGTGT -> GACCTGTTGAACACGTGTG
CTGATATTTGCTATTTGTT -> TGATATTTGCTATTTGTTC
GTCCTTTAATACTCTCTTC -> TCCTTTAATACTCTCTTCC
TTGATGAGCGTCCGGGCCA -> TGATGAGCGTCCGGGCCAC
GTTACAATCGGGCAACACT -> TTACAATCGGGCAACACTA
ATGTTAAGAAACCTTCCAC -> TGTTAAGAAACCTTCCACA
TCGGCTAGATTACGACTGA -> CGGCTAGATTACGACTGAT
GGCCGGGACTTGGGAACGC -> GCCGGGACTTGGGAACGCT
TGAAGGCGCGGTCCGGACA -> GAAGGCGCGGTCCGGACAC
AGCACGATGGTAACCTCTC -> GCACGATGGTAACCTCTCT
GCTTTGACTCATCTAGGCG -> CTTTGACTCATCTAGGCGT
TGCGGCTGGCTACTACTGC -> GCGGCTGGCTACTACTGCC
GCGGTCCGGACACCTCCCT -> CGGTCCGGACACCTCCCTA, CGGTCCGGACACCTCCCTA
GTGCTGCAACACTATCGTG -> TGCTGCAACACTATCGTGC
ACAGGGTCTTCCCGCTGTA -> CAGGGTCTTCCCGCTGTAC
GGTTGCAATCGAGTACTAC -> GTTGCAATCGAGTACTACG
TATGGTTGCAATCGAGTAC -> ATGGTTGCAATCGAGTACT
TTGTACGTGAAGGCGCGGT -> TGTACGTGAAGGCGCGGTC
GTTCGCTGAGGGACCGCAT -> TTCGCTGAGGGACCGCATA
GCGGTTGCCCTCGATTGCA -> CGGTTGCCCTCGATTGCAT
TATGAATAAATACTAGTAT -> ATGAATAAATACTAGTATT
ACTTATCGTCCGATTGGCT -> CTTATCGTCCGATTGGCTG
ATGGGAAGCCAAACTAAGT -> TGGGAAGCCAAACTAAGTG
TCACTAATGTTTCGCGGTC -> CACTAATGTTTCGCGGTCC
GCGGGTTCGCTGAGGGACC -> CGGGTTCGCTGAGGGACCG
TACAATCGGGCAACACTAG -> ACAATCGGGCAACACTAGT
ACTAGTTTCACCTCCTATT -> CTAGTTTCACCTCCTATTA
GCATTCAGGTACGTCAGGG -> CATTCAGGTACGTCAGGGC
ATATCGAGCTTATCGCGAG -> TATCGAGCTTATCGCGAGT
GATATTTGCTATTTGTTCG -> ATATTTGCTATTTGTTCGT
ACGTAATATACAACAGGGT -> CGTAATATACAACAGGGTC
TTCACCTCCTATTATCCTG -> TCACCTCCTATTATCCTGC
GATGACGTTAGGACCAACC -> ATGACGTTAGGACCAACCA
CCTCCCCGGAGTTGCAGGT -> CTCCCCGGAGTTGCAGGTT
TATCGTGCAAACAGAGGCG -> ATCGTGCAAACAGAGGCGT
CCTATTTCGAAATTCAACG -> CTATTTCGAAATTCAACGC
GGTCTCGCCGACTTCCAGC -> GTCTCGCCGACTTCCAGCA
GTCTCGCCGACTTCCAGCA -> TCTCGCCGACTTCCAGCAA
TTAGGACCAACCATCCGCA -> TAGGACCAACCATCCGCAG
TCGTCCCAACCGTGCCGGG -> CGTCCCAACCGTGCCGGGT
CTCTTTGTCCCGACAGCTC -> TCTTTGTCCCGACAGCTCC
GAGTTGCAGGTTCTCCCAT -> AGTTGCAGGTTCTCCCATC
ATCATCTCGAGTGGGATGT -> TCATCTCGAGTGGGATGTG
GGGAACCTTCCTCCACAGT -> GGAACCTTCCTCCACAGTG
GTTGCAGGTTCTCCCATCG -> TTGCAGGTTCTCCCATCGG
CACGGCTGAGGGGACGTAC -> ACGGCTGAGGGGACGTACT
GGTGGGAAGGTTATGTACT -> GTGGGAAGGTTATGTACTA
GCACGTAGTTGATGAGCGT -> CACGTAGTTGATGAGCGTC
TAATCGGCAGGATTGGACT -> AATCGGCAGGATTGGACTA
TTCCTTAATTGTGTAACCC -> TCCTTAATTGTGTAACCCG
TTCGAAGTATAAACGGGCC -> TCGAAGTATAAACGGGCCG
CGGTCCGGACACCTCCCCT -> GGTCCGGACACCTCCCCTC
TCAACAAAGTCCAACGCCT -> CAACAAAGTCCAACGCCTT
ACTAATAAGAATTTCAGAA -> CTAATAAGAATTTCAGAAA
ACACGTGTGCTGCAACACT -> CACGTGTGCTGCAACACTA
TTAACCCAAAGGTATAGGA -> TAACCCAAAGGTATAGGAC
GGGCCGGGACTTGGGAACG -> GGCCGGGACTTGGGAACGC
ACAAAGTCCAACGCCTTTC -> CAAAGTCCAACGCCTTTCC
ACTACGGTGGATCGTCCCA -> CTACGGTGGATCGTCCCAA
ACTACAGTATAGAGTATGG -> CTACAGTATAGAGTATGGC
AGATATCGAGCTTATCGCG -> GATATCGAGCTTATCGCGA
AGGACATTCTTTGGTGGGA -> GGACATTCTTTGGTGGGAA
GTCTATTTTTTGGCATGTT -> TCTATTTTTTGGCATGTTA
TCCTGCTTTACGCGGTCCG -> CCTGCTTTACGCGGTCCGG
GTGTGCCACGTGACCCAGG -> TGTGCCACGTGACCCAGGT
TGAACTCCTAGTTTCACCT -> GAACTCCTAGTTTCACCTC
GAGGCTTCCTTAATTGTGT -> AGGCTTCCTTAATTGTGTA
AAGAGAAGTGAGCGCTCGT -> AGAGAAGTGAGCGCTCGTT
ACCCGTTGTTATGTTTGGT -> CCCGTTGTTATGTTTGGTC
CGGACACCTCCCCGGAGTT -> GGACACCTCCCCGGAGTTG
ACACTATCGTGCAAACAGA -> CACTATCGTGCAAACAGAG
AATACGGTTAGCATAAGTG -> ATACGGTTAGCATAAGTGT
GTAACCTCTCTCCGACGGC -> TAACCTCTCTCCGACGGCT
TTGGCGATGCTCTTTGTCC -> TGGCGATGCTCTTTGTCCC
TCCGCTAGTTTCACCTCCT -> CCGCTAGTTTCACCTCCTA
ACACCTCCCTAAATATTAG -> CACCTCCCTAAATATTAGA
CGTGTGCTTCTCCGAAAAA -> GTGTGCTTCTCCGAAAAAT
AAGAAACCTTCCACAGACT -> AGAAACCTTCCACAGACTT
TGCTTTGACTCATCTAGGC -> GCTTTGACTCATCTAGGCG
ACGAGCACAAGTTACAATC -> CGAGCACAAGTTACAATCG
GTTTAACAATCCCGTTTTC -> TTTAACAATCCCGTTTTCC
CACCTCACTGGGGTCTTTC -> ACCTCACTGGGGTCTTTCC
CCCCTACCCGCGACCCCAG -> CCCTACCCGCGACCCCAGT
CGTCAGACCTCCACCATTG -> GTCAGACCTCCACCATTGG
TAGGCGCACGCTCCCCTAC -> AGGCGCACGCTCCCCTACC
TACGACTGATATTTGCTAT -> ACGACTGATATTTGCTATT
TGTTTTCTTCCCTCTAGGA -> GTTTTCTTCCCTCTAGGAT
CAGGTACGTCAGGGCTAAG -> AGGTACGTCAGGGCTAAGA
AATCGGGCAACACTAGTTT -> ATCGGGCAACACTAGTTTC
TAAGTTCTGGCTCATGCTT -> AAGTTCTGGCTCATGCTTT
CCCAACCGTGCCGGGTCGT -> CCAACCGTGCCGGGTCGTC
CCATCTATCGTAGGCTCAT -> CATCTATCGTAGGCTCATC
CTGCTTTACGCGGTCCGGA -> TGCTTTACGCGGTCCGGAC
ATAGAGTATATGCGACTTA -> TAGAGTATATGCGACTTAA
TCTTTCCTAATGGGAGGCT -> CTTTCCTAATGGGAGGCTG
CGTTGTCAACAAAGTCCAA -> GTTGTCAACAAAGTCCAAC
AACCATCCCGGCCATAATG -> ACCATCCCGGCCATAATGT
GGAGGCTGTGGCGTGACTA -> GAGGCTGTGGCGTGACTAC
GCACCCGTTGTTATGTTTG -> CACCCGTTGTTATGTTTGG
TGTACTTATCGTCCGATTG -> GTACTTATCGTCCGATTGG
ATCTAAATCGTGTTACCAC -> TCTAAATCGTGTTACCACC
TAATACTCTCTTCCGAGCT -> AATACTCTCTTCCGAGCTT
TCCCTCTAGGATTTTGCGT -> CCCTCTAGGATTTTGCGTG
AGAGGCGTAGCCGACCAGC -> GAGGCGTAGCCGACCAGCC
AACACCTCACTGGGGTCTT -> ACACCTCACTGGGGTCTTT
GCGCGGTCCGGACACCTCC -> CGCGGTCCGGACACCTCCC
AATACTCTCTTCCGAGCTT -> ATACTCTCTTCCGAGCTTA
CCGCGAGCCTTGTTCGAAG -> CGCGAGCCTTGTTCGAAGT
TAAGACATCGTATAGGTAT -> AAGACATCGTATAGGTATA
CTTAACGTAATGGGACACG -> TTAACGTAATGGGACACGC
TTGGCTTAACGTAATGGGA -> TGGCTTAACGTAATGGGAC
ACTCTCTTCCGAGCTTAAG -> CTCTCTTCCGAGCTTAAGG
ACGGTCGCCCTCGCCCAAA -> CGGTCGCCCTCGCCCAAAT
CTACACTCGATATGTTGAG -> TACACTCGATATGTTGAGC
GATGGACGGAGGAGGCTTC -> ATGGACGGAGGAGGCTTCC
ATCACTGATTACGCACGTA -> TCACTGATTACGCACGTAG
CTCGATTTGCGTTCGGGGC -> TCGATTTGCGTTCGGGGCA
ACTTACCTTGAGACCTGTT -> CTTACCTTGAGACCTGTTG
CTCCTATTATCCTGCTTTA -> TCCTATTATCCTGCTTTAC
TGCGTTCGGGGCAGTCTCA -> GCGTTCGGGGCAGTCTCAT
CTGTGGCGTGACTACGGTG -> TGTGGCGTGACTACGGTGG
CCTACACGGCTGAGGGGAC -> CTACACGGCTGAGGGGACG
CCACAGACTTTTACATAGA -> CACAGACTTTTACATAGAT
GAACGCTAGCCCTAAGTTC -> AACGCTAGCCCTAAGTTCT
CTAGTATTAGCCGTCTTGG -> TAGTATTAGCCGTCTTGGA
GACGAGCACAAGTTACAAT -> ACGAGCACAAGTTACAATC
TAAGAAACCTTCCACAGAC -> AAGAAACCTTCCACAGACT
AAATATTAGATGCTTAATA -> AATATTAGATGCTTAATAG
AGAAACCTTCCACAGACTT -> GAAACCTTCCACAGACTTT
TTCACCTCCTATTTCGAAA -> TCACCTCCTATTTCGAAAT
CAGTATTGGTTATGAATAA -> AGTATTGGTTATGAATAAA
GAATGCACCCGTTGTTATG -> AATGCACCCGTTGTTATGT
CACACAGTGGGAACCTTCC -> ACACAGTGGGAACCTTCCT
CGAGTAGATATCGAGCTTA -> GAGTAGATATCGAGCTTAT
CGAGCCTCCGCTAGTTTCA -> GAGCCTCCGCTAGTTTCAC
CTTAATTGTGTAACCCGTG -> TTAATTGTGTAACCCGTGA
GACTCATCTAGGCGTCTAT -> ACTCATCTAGGCGTCTATT
TGAGGGGACGTACTGGGTT -> GAGGGGACGTACTGGGTTC
AAAAATAATCGGATTTGAA -> AAAATAATCGGATTTGAAC
GACCTCCCATACCGCCTCG -> ACCTCCCATACCGCCTCGA
ATGACGTTAGGACCAACCA -> TGACGTTAGGACCAACCAT
GACCGTATCGGCTAGATTA -> ACCGTATCGGCTAGATTAC
TATCGCGAGTCGCGGTATT -> ATCGCGAGTCGCGGTATTG
CAGGATTGGACTAATAAGA -> AGGATTGGACTAATAAGAA
ACACCTCACTGGGGTCTTT -> CACCTCACTGGGGTCTTTC
TGGCTGGACGGAACAGTTT -> GGCTGGACGGAACAGTTTC
ACCTTCCTCCACAGTGGAT -> CCTTCCTCCACAGTGGATC
TGAGCGCTCGTTGTCAACA -> GAGCGCTCGTTGTCAACAA
GTTCGGGGCAGTCTCATGG -> TTCGGGGCAGTCTCATGGG
CACTAGTTTCACCTCCTAT -> ACTAGTTTCACCTCCTATT
CCCGTTGTTATGTTTGGTC -> CCGTTGTTATGTTTGGTCA
TCTCGATTTGCGTTCGGGG -> CTCGATTTGCGTTCGGGGC
CTGTACGGGAGGTGAATGC -> TGTACGGGAGGTGAATGCA
TTAAGTAAGCTGGTAGAAT -> TAAGTAAGCTGGTAGAATA
ATTCCAAAGTCATGCAACT -> TTCCAAAGTCATGCAACTC
ACCACACAGTGGGAACCTT -> CCACACAGTGGGAACCTTC
CACTCGATATGTTGAGCGC -> ACTCGATATGTTGAGCGCC
GTTGGCTTAACGTAATGGG -> TTGGCTTAACGTAATGGGA
CAGCCAGACACGTATGGTT -> AGCCAGACACGTATGGTTG
GACAGGCGATTTCTCACCC -> ACAGGCGATTTCTCACCCT
GTACGTGAAGGCGCGGTCC -> TACGTGAAGGCGCGGTCCG
AGTTTTCCCGATGGACGGA -> GTTTTCCCGATGGACGGAG
ATTTGTTCGTTACAAGAGT -> TTTGTTCGTTACAAGAGTC
TCTGTTTGTGGTGCGGCTG -> CTGTTTGTGGTGCGGCTGG
CCCTAAATATTAGATGCTT -> CCTAAATATTAGATGCTTA
GACACGTATGGTTGCAATC -> ACACGTATGGTTGCAATCG
GCACAAGTTACAATCGGGC -> CACAAGTTACAATCGGGCA
ATGCTTTGACTCATCTAGG -> TGCTTTGACTCATCTAGGC
AGGATTGGACTAATAAGAA -> GGATTGGACTAATAAGAAT
CGTTGTTATGTTTGGTCAG -> GTTGTTATGTTTGGTCAGA
CGACTTCCAGCAAAATCTC -> GACTTCCAGCAAAATCTCG
TTGCAATCGAGTACTACGT -> TGCAATCGAGTACTACGTT
CGTAATGGGACACGCACAC -> GTAATGGGACACGCACACA
GACAATCACTGATTACGCA -> ACAATCACTGATTACGCAC
ACTCATCTAGGCGTCTATT -> CTCATCTAGGCGTCTATTT
CAAGTTACAATCGGGCAAC -> AAGTTACAATCGGGCAACA
TTCCACGAGTTATTGTTCT -> TCCACGAGTTATTGTTCTA
ACCTCTCTCCGACGGCTTG -> CCTCTCTCCGACGGCTTGT
GTAATGGGACACGCACACA -> TAATGGGACACGCACACAC
GGAGTTGCAGGTTCTCCCA -> GAGTTGCAGGTTCTCCCAT
GATGAGCGTCCGGGCCACC -> ATGAGCGTCCGGGCCACCA
TGGCGACAATCACTGATTA -> GGCGACAATCACTGATTAC
AACAGTTTCCACGTAATAT -> ACAGTTTCCACGTAATATA
TCTTGGAAGCCTACACGGC -> CTTGGAAGCCTACACGGCT
TGGGAAGGTTATGTACTAG -> GGGAAGGTTATGTACTAGG
TTCCACGTAATATACAACA -> TCCACGTAATATACAACAG
GCATAGAGTATATGCGACT -> CATAGAGTATATGCGACTT
TCGTCCGATTGGCTGGACG -> CGTCCGATTGGCTGGACGG
GTCAGACGCCATCTATCGT -> TCAGACGCCATCTATCGTA
GATTTCTCACCCTACTTAC -> ATTTCTCACCCTACTTACC
ACTCAGTGTTTTCTTCCCT -> CTCAGTGTTTTCTTCCCTC
GAGTATATGCGACTTAATT -> AGTATATGCGACTTAATTT
TAGCCGTCTTGGAAGCCTA -> AGCCGTCTTGGAAGCCTAC
CGGTTCATCCTTAACCCAA -> GGTTCATCCTTAACCCAAA
CGTCCGGGCCACCAGATAC -> GTCCGGGCCACCAGATACG
GTTATTGTTCTAGTTTCAC -> TTATTGTTCTAGTTTCACC
GGGCAGAGTAAGTTTTCCC -> GGCAGAGTAAGTTTTCCCG
ATTTACGAGGTTGTCCTGA -> TTTACGAGGTTGTCCTGAA
CGCGGTATTGCCGTGGAGC -> GCGGTATTGCCGTGGAGCG
AGCGCTCGTTGTCAACAAA -> GCGCTCGTTGTCAACAAAG
TATGCGACTTAATTTGACC -> ATGCGACTTAATTTGACCT
CGGCTGAGGGGACGTACTG -> GGCTGAGGGGACGTACTGG
GCCACGTGACCCAGGTAAC -> CCACGTGACCCAGGTAACC
GCGGAGATGACGTTAGGAC -> CGGAGATGACGTTAGGACC
CATAGAGTATATGCGACTT -> ATAGAGTATATGCGACTTA
GCGCCAGGTCTCGCCGACT -> CGCCAGGTCTCGCCGACTT
GGCAATGCGGGTTCGCTGA -> GCAATGCGGGTTCGCTGAG
TCCCTATTATTTACGAGGT -> CCCTATTATTTACGAGGTT
AGAGTCGCGTTTCCGTAAG -> GAGTCGCGTTTCCGTAAGC
AGATCTCGTCAGACCTCCA -> GATCTCGTCAGACCTCCAC
CGAAATTCAACGCGGTCCG -> GAAATTCAACGCGGTCCGG
CCATCCCGGCCATAATGTA -> CATCCCGGCCATAATGTAC
GAGCACAAGTTACAATCGG -> AGCACAAGTTACAATCGGG
GGTGGATCGTCCCAACCGT -> GTGGATCGTCCCAACCGTG
ATACCGCCTCGAGTAGATA -> TACCGCCTCGAGTAGATAT
TTTCCGCGAGCCTTGTTCG -> TTCCGCGAGCCTTGTTCGA
AGTAGATATCGAGCTTATC -> GTAGATATCGAGCTTATCG
CCTTGAGACCTGTTGAACA -> CTTGAGACCTGTTGAACAC
GGGCCACCAGATACGGTAG -> GGCCACCAGATACGGTAGC
ATTGTGTAACCCGTGACGG -> TTGTGTAACCCGTGACGGT
CTCCGAAAAATAATCGGAT -> TCCGAAAAATAATCGGATT
GTGTGGTTTAGACACTACA -> TGTGGTTTAGACACTACAG
GTGACTACGGTGGATCGTC -> TGACTACGGTGGATCGTCC
GGGACGTACTGGGTTCGTA -> GGACGTACTGGGTTCGTAC
CTAGCGGAACAGATGTAAA -> TAGCGGAACAGATGTAAAC
CTAATGGGAGGCTGTGGCG -> TAATGGGAGGCTGTGGCGT
CTCAGAGGCATAGAGTATA -> TCAGAGGCATAGAGTATAT
TTCCGCGAGCCTTGTTCGA -> TCCGCGAGCCTTGTTCGAA
GGTCAGACGCCATCTATCG -> GTCAGACGCCATCTATCGT
AGGATTTTGCGTGTTCAAC -> GGATTTTGCGTGTTCAACC
GTTTAGACACTACAGTATA -> TTTAGACACTACAGTATAG
CTCGAGTGCCCATCCCATG -> TCGAGTGCCCATCCCATGG
CTACTGCCGATTTCCTGTG -> TACTGCCGATTTCCTGTGC
GAGGACCGTATCGGCTAGA -> AGGACCGTATCGGCTAGAT
TAATTGTGTAACCCGTGAC -> AATTGTGTAACCCGTGACG
GTATTAGCCGTCTTGGAAG -> TATTAGCCGTCTTGGAAGC
CACAGACTTTTACATAGAT -> ACAGACTTTTACATAGATC
CAGTGTTTTCTTCCCTCTA -> AGTGTTTTCTTCCCTCTAG
ACAGTGGGAACCTTCCTCC -> CAGTGGGAACCTTCCTCCA
TACTTACCTTGAGACCTGT -> ACTTACCTTGAGACCTGTT
AAGTTACAATCGGGCAACA -> AGTTACAATCGGGCAACAC
CTCCCCTCATAATCGGCAG -> TCCCCTCATAATCGGCAGG
ACTGGGTTCGTACAGTTGG -> CTGGGTTCGTACAGTTGGC
GTGAGGACATTCTTTGGTG -> TGAGGACATTCTTTGGTGG
AGACCTCCACCATTGGCGA -> GACCTCCACCATTGGCGAT
CGGAGGAGGCTTCCTTAAT -> GGAGGAGGCTTCCTTAATT
TACACTCGATATGTTGAGC -> ACACTCGATATGTTGAGCG
CCGACGGCTTGTGATGAGA -> CGACGGCTTGTGATGAGAC
GCGAGCCTTGTTCGAAGTA -> CGAGCCTTGTTCGAAGTAT
GTTCGTTACAAGAGTCGCG -> TTCGTTACAAGAGTCGCGT
CTTCCAGCAAAATCTCGAG -> TTCCAGCAAAATCTCGAGT
AGTCGCGTTTCCGTAAGCC -> GTCGCGTTTCCGTAAGCCG
GCTACTACTGCCGATTTCC -> CTACTACTGCCGATTTCCT
ACGCCATCTATCGTAGGCT -> CGCCATCTATCGTAGGCTC
TTCTGGCTCATGCTTTGAC -> TCTGGCTCATGCTTTGACT
CTAGTTTCACCTCCTATTT -> TAGTTTCACCTCCTATTTC
CAGGGCTAAGACATCGTAT -> AGGGCTAAGACATCGTATA
GTAACCCGTGACGGTCGCC -> TAACCCGTGACGGTCGCCC
TCAGGTACGTCAGGGCTAA -> CAGGTACGTCAGGGCTAAG
AGGCGATTTCTCACCCTAC -> GGCGATTTCTCACCCTACT
GACACCTCCCCTCATAATC -> ACACCTCCCCTCATAATCG
TGGCATGTTAAGAAACCTT -> GGCATGTTAAGAAACCTTC
TATGGGAAGCCAAACTAAG -> ATGGGAAGCCAAACTAAGT
ACAGTTTCCACGTAATATA -> CAGTTTCCACGTAATATAC
TATTAGCCGTCTTGGAAGC -> ATTAGCCGTCTTGGAAGCC
ATCCCGGCCATAATGTACT -> TCCCGGCCATAATGTACTT
GTATAGAGTATGGCGGTTG -> TATAGAGTATGGCGGTTGC
TTATCGCGAGTCGCGGTAT -> TATCGCGAGTCGCGGTATT
TGTGATGAGACAGGCGATT -> GTGATGAGACAGGCGATTT
ATCCTGCTTTACGCGGTCC -> TCCTGCTTTACGCGGTCCG
TTTCAGAAAAACACCTCAC -> TTCAGAAAAACACCTCACT
GTAAGCCGAGCCTCCGCTA -> TAAGCCGAGCCTCCGCTAG
CCTCTCTCCGACGGCTTGT -> CTCTCTCCGACGGCTTGTG
CTCCTATTCACTAATGTTT -> TCCTATTCACTAATGTTTC
AATTCTTAAGTAAGCTGGT -> ATTCTTAAGTAAGCTGGTA
TCGTCAGACCTCCACCATT -> CGTCAGACCTCCACCATTG
GGGTCTTCCCGCTGTACGG -> GGTCTTCCCGCTGTACGGG
TACTACGTTTAACAATCCC -> ACTACGTTTAACAATCCCG
AAGGCGCGGTCCGGACACC -> AGGCGCGGTCCGGACACCT
CTCGTTGTCAACAAAGTCC -> TCGTTGTCAACAAAGTCCA
TCACCCTACTTACCTTGAG -> CACCCTACTTACCTTGAGA
AGGCGCGGTCCGGACACCT -> GGCGCGGTCCGGACACCTC
CGGCAGGATTGGACTAATA -> GGCAGGATTGGACTAATAA
AGGAGGCTTCCTTAATTGT -> GGAGGCTTCCTTAATTGTG
CGGTCCGGACACCTCCCTA -> GGTCCGGACACCTCCCTAA, GGTCCGGACACCTCCCTAT
GTCAACAAAGTCCAACGCC -> TCAACAAAGTCCAACGCCT
TGAGACAGGCGATTTCTCA -> GAGACAGGCGATTTCTCAC
CAGATGTAAACGGACGAGC -> AGATGTAAACGGACGAGCA
TTGCAGGTTCTCCCATCGG -> TGCAGGTTCTCCCATCGGT
GAACAGTTTCCACGTAATA -> AACAGTTTCCACGTAATAT
TATCCTGCTTTACGCGGTC -> ATCCTGCTTTACGCGGTCC
ACCTCCCTAAATATTAGAT -> CCTCCCTAAATATTAGATG
CGGACACCTCCCTAAATAT -> GGACACCTCCCTAAATATT
TGGAAGCCTACACGGCTGA -> GGAAGCCTACACGGCTGAG
CACTAATGTTTCGCGGTCC -> ACTAATGTTTCGCGGTCCG
TCTAGTTTCACCTCCTATT -> CTAGTTTCACCTCCTATTT
CGTTTAACAATCCCGTTTT -> GTTTAACAATCCCGTTTTC
AGTTTCACCTCCTATTTCG -> GTTTCACCTCCTATTTCGA
TAGAGTATGGCGGTTGCCC -> AGAGTATGGCGGTTGCCCT
CCGAGCTTAAGGGATAGCA -> CGAGCTTAAGGGATAGCAA
TCGAAGTATAAACGGGCCG -> CGAAGTATAAACGGGCCGG
AGAGTATGGCGGTTGCCCT -> GAGTATGGCGGTTGCCCTC
CAGGGTCTTCCCGCTGTAC -> AGGGTCTTCCCGCTGTACG
CGGGCCGGGACTTGGGAAC -> GGGCCGGGACTTGGGAACG
ACATCGTATAGGTATAGGG -> CATCGTATAGGTATAGGGA
CCTCCGCTAGTTTCACCTC -> CTCCGCTAGTTTCACCTCC
CTTGGAAGCCTACACGGCT -> TTGGAAGCCTACACGGCTG
TTTTGCGTGTTCAACCATC -> TTTGCGTGTTCAACCATCC
TAATGGGACACGCACACAC -> AATGGGACACGCACACACC
TAAACGGGCCGGGACTTGG -> AAACGGGCCGGGACTTGGG
TATACAACAGGGTCTTCCC -> ATACAACAGGGTCTTCCCG
AATGGGACACGCACACACC -> ATGGGACACGCACACACCG
TACTAGGTTCGCCAAAGAC -> ACTAGGTTCGCCAAAGACG
ATGACAGCCCCCGAGCAAG -> TGACAGCCCCCGAGCAAGA
TACTGCCGATTTCCTGTGC -> ACTGCCGATTTCCTGTGCA
GGGACTTGGGAACGCTAGC -> GGACTTGGGAACGCTAGCC
GTCAGGGCTAAGACATCGT -> TCAGGGCTAAGACATCGTA
GACGTACTGGGTTCGTACA -> ACGTACTGGGTTCGTACAG
CCCGCTGTACGGGAGGTGA -> CCGCTGTACGGGAGGTGAA
CACGCACACACCGTGTGCC -> ACGCACACACCGTGTGCCA
CGAAAAATAATCGGATTTG -> GAAAAATAATCGGATTTGA
ATAAACCACACAGTGGGAA -> TAAACCACACAGTGGGAAC
ACGACTGATATTTGCTATT -> CGACTGATATTTGCTATTT
GCTCCGCTAGCGGAACAGA -> CTCCGCTAGCGGAACAGAT
ACAGCTCCGCTAGCGGAAC -> CAGCTCCGCTAGCGGAACA
CCGACAGCTCCGCTAGCGG -> CGACAGCTCCGCTAGCGGA
CGATATGTTGAGCGCCAGG -> GATATGTTGAGCGCCAGGT
GGCAGGATTGGACTAATAA -> GCAGGATTGGACTAATAAG
GTATGGGAAGCCAAACTAA -> TATGGGAAGCCAAACTAAG
TCCGGACACCTCCCTATTA -> CCGGACACCTCCCTATTAT
TTCCGAGCTTAAGGGATAG -> TCCGAGCTTAAGGGATAGC
CGATTTGCGTTCGGGGCAG -> GATTTGCGTTCGGGGCAGT
TACAGTATAGAGTATGGCG -> ACAGTATAGAGTATGGCGG
CTCCACAGTGGATCTGAAT -> TCCACAGTGGATCTGAATA
TCCGGACACCTCCCTAAAT -> CCGGACACCTCCCTAAATA
CGCATAAACCACACAGTGG -> GCATAAACCACACAGTGGG
GTCGACCGGCTACACTCGA -> TCGACCGGCTACACTCGAT
ACCCAGGTAACCTGGGGCC -> CCCAGGTAACCTGGGGCCT
AGCCTACACGGCTGAGGGG -> GCCTACACGGCTGAGGGGA
CTCAGTGTTTTCTTCCCTC -> TCAGTGTTTTCTTCCCTCT
ACAAGAGTCGCGTTTCCGT -> CAAGAGTCGCGTTTCCGTA
CACAGTGGGAACCTTCCTC -> ACAGTGGGAACCTTCCTCC
CCTCCTATTATCCTGCTTT -> CTCCTATTATCCTGCTTTA
ACACGCACACACCGTGTGC -> CACGCACACACCGTGTGCC
TGTTGAGCGCCAGGTCTCG -> GTTGAGCGCCAGGTCTCGC
AAAACGCCGTGTGCTTCTC -> AAACGCCGTGTGCTTCTCC
CTCCCCGGAGTTGCAGGTT -> TCCCCGGAGTTGCAGGTTC
GAGTACTACGTTTAACAAT -> AGTACTACGTTTAACAATC
GTAAGTTTTCCCGATGGAC -> TAAGTTTTCCCGATGGACG
ATAAGTGGGCCTGCGTCCA -> TAAGTGGGCCTGCGTCCAA
TTTCCCGATGGACGGAGGA -> TTCCCGATGGACGGAGGAG
TGCATTCAGGTACGTCAGG -> GCATTCAGGTACGTCAGGG
GGACCGCATAAACCACACA -> GACCGCATAAACCACACAG
TTTAATACTCTCTTCCGAG -> TTAATACTCTCTTCCGAGC
ATCTGAATATCTAAATCGT -> TCTGAATATCTAAATCGTG
CCGGGACTTGGGAACGCTA -> CGGGACTTGGGAACGCTAG
ACAGCCCCCGAGCAAGAGA -> CAGCCCCCGAGCAAGAGAA
GCTTATCGCGAGTCGCGGT -> CTTATCGCGAGTCGCGGTA
TGTGCATAGGCTCTCGATT -> GTGCATAGGCTCTCGATTT
TGTACGTGAAGGCGCGGTC -> GTACGTGAAGGCGCGGTCC
GGTCCGGACACCTCCCTAT -> GTCCGGACACCTCCCTATT
TTTGTTCGTTACAAGAGTC -> TTGTTCGTTACAAGAGTCG
TCTCATGGGGCAGAGTAAG -> CTCATGGGGCAGAGTAAGT
TTACCTTGAGACCTGTTGA -> TACCTTGAGACCTGTTGAA
ATACTCTCTTCCGAGCTTA -> TACTCTCTTCCGAGCTTAA
AACGTAATGGGACACGCAC -> ACGTAATGGGACACGCACA
CGGATTTGAACTCCTAGTT -> GGATTTGAACTCCTAGTTT
ATTTCCTGTGCATAGGCTC -> TTTCCTGTGCATAGGCTCT
GGGAAGCCAAACTAAGTGT -> GGAAGCCAAACTAAGTGTA
AGCGGAGATGACGTTAGGA -> GCGGAGATGACGTTAGGAC
GTAGCCGACCAGCCAGACA -> TAGCCGACCAGCCAGACAC
TATCGGCTAGATTACGACT -> ATCGGCTAGATTACGACTG
CGAGCTTAAGGGATAGCAA -> GAGCTTAAGGGATAGCAAG
GCAGTCTCATGGGGCAGAG -> CAGTCTCATGGGGCAGAGT
CCTTCCACAGACTTTTACA -> CTTCCACAGACTTTTACAT
TAGATCTCGTCAGACCTCC -> AGATCTCGTCAGACCTCCA
ATTACGACTGATATTTGCT -> TTACGACTGATATTTGCTA
CGAGCACAAGTTACAATCG -> GAGCACAAGTTACAATCGG
ACTTCCAGCAAAATCTCGA -> CTTCCAGCAAAATCTCGAG
TATAAACGGGCCGGGACTT -> ATAAACGGGCCGGGACTTG
GGGCTAAGACATCGTATAG -> GGCTAAGACATCGTATAGG
GAGGCATAGAGTATATGCG -> AGGCATAGAGTATATGCGA
CACCTCCCTATTATTTACG -> ACCTCCCTATTATTTACGA
TCATCTCGAGTGGGATGTG -> CATCTCGAGTGGGATGTGT
TAGTTTCACCTCCTATTTC -> AGTTTCACCTCCTATTTCG
TAAGTGGGCCTGCGTCCAA -> AAGTGGGCCTGCGTCCAAT
AAGCCAAACTAAGTGTATA -> AGCCAAACTAAGTGTATAA
TCCGATTCCAAAGTCATGC -> CCGATTCCAAAGTCATGCA
CCTTTCCGCGAGCCTTGTT -> CTTTCCGCGAGCCTTGTTC
AGCTTATCGCGAGTCGCGG -> GCTTATCGCGAGTCGCGGT
TTTGACCTCCCATACCGCC -> TTGACCTCCCATACCGCCT
TTCAGGTACGTCAGGGCTA -> TCAGGTACGTCAGGGCTAA
GATGGTAACCTCTCTCCGA -> ATGGTAACCTCTCTCCGAC
AATCGTGTTACCACCCGGT -> ATCGTGTTACCACCCGGTA
AACACTATCGTGCAAACAG -> ACACTATCGTGCAAACAGA
GGCGTGACTACGGTGGATC -> GCGTGACTACGGTGGATCG
AGCCGTCTTGGAAGCCTAC -> GCCGTCTTGGAAGCCTACA
ATGAGCGTCCGGGCCACCA -> TGAGCGTCCGGGCCACCAG
GAGACCTGTTGAACACGTG -> AGACCTGTTGAACACGTGT
CGTGACGGTCGCCCTCGCC -> GTGACGGTCGCCCTCGCCC
CGACAGCTCCGCTAGCGGA -> GACAGCTCCGCTAGCGGAA
GAGTTATTGTTCTAGTTTC -> AGTTATTGTTCTAGTTTCA
AGGTATAGGACTCAGTGTT -> GGTATAGGACTCAGTGTTT
CCTAAATATTAGATGCTTA -> CTAAATATTAGATGCTTAA
ACCTTCCACAGACTTTTAC -> CCTTCCACAGACTTTTACA
TCGCCAAAGACGAGGCACT -> CGCCAAAGACGAGGCACTG
CAAAATCTCGAGTGCCCAT -> AAAATCTCGAGTGCCCATC
TATAAGTGGGCCTGCGTCC -> ATAAGTGGGCCTGCGTCCA
ACCTCCCCGGAGTTGCAGG -> CCTCCCCGGAGTTGCAGGT
TACAAGAGTCGCGTTTCCG -> ACAAGAGTCGCGTTTCCGT
CGGTTAGCATAAGTGTAGG -> GGTTAGCATAAGTGTAGGT
TGCTTTACGCGGTCCGGAC -> GCTTTACGCGGTCCGGACA
GGCATAGAGTATATGCGAC -> GCATAGAGTATATGCGACT
CTAGATTACGACTGATATT -> TAGATTACGACTGATATTT
TCCCAACCGTGCCGGGTCG -> CCCAACCGTGCCGGGTCGT
ACCGTGCCGGGTCGTCCTT -> CCGTGCCGGGTCGTCCTTT
GCTAGCCCTAAGTTCTGGC -> CTAGCCCTAAGTTCTGGCT
TTCGAAATTCAACGCGGTC -> TCGAAATTCAACGCGGTCC
GCCCTAAGTTCTGGCTCAT -> CCCTAAGTTCTGGCTCATG
GACCGGCTACACTCGATAT -> ACCGGCTACACTCGATATG
GTGCAAACAGAGGCGTAGC -> TGCAAACAGAGGCGTAGCC
AGTGTTTTCTTCCCTCTAG -> GTGTTTTCTTCCCTCTAGG
TACGTGAAGGCGCGGTCCG -> ACGTGAAGGCGCGGTCCGG
ACGGCTTGTGATGAGACAG -> CGGCTTGTGATGAGACAGG
AGTATGGCGGTTGCCCTCG -> GTATGGCGGTTGCCCTCGA
CCTCCTATTCACTAATGTT -> CTCCTATTCACTAATGTTT
TGTCAACAAAGTCCAACGC -> GTCAACAAAGTCCAACGCC
CCCTCTAGGATTTTGCGTG -> CCTCTAGGATTTTGCGTGT
CGGACACCTCCCTATTATT -> GGACACCTCCCTATTATTT
GCGAGTCGCGGTATTGCCG -> CGAGTCGCGGTATTGCCGT
CGGCTACACTCGATATGTT -> GGCTACACTCGATATGTTG
GGATTTGAACTCCTAGTTT -> GATTTGAACTCCTAGTTTC
TTTTGGCATGTTAAGAAAC -> TTTGGCATGTTAAGAAACC
TAAGTGTAGGTGAGGACAT -> AAGTGTAGGTGAGGACATT
GTTTCCACGTAATATACAA -> TTTCCACGTAATATACAAC
TCCTAATGGGAGGCTGTGG -> CCTAATGGGAGGCTGTGGC
ACCTCCTATTCACTAATGT -> CCTCCTATTCACTAATGTT
CTATTATCCTGCTTTACGC -> TATTATCCTGCTTTACGCG
ATTTGACCTCCCATACCGC -> TTTGACCTCCCATACCGCC
CGGTATGGGAAGCCAAACT -> GGTATGGGAAGCCAAACTA
CTCCTATTGTACGTGAAGG -> TCCTATTGTACGTGAAGGC
CGTGACTACGGTGGATCGT -> GTGACTACGGTGGATCGTC
CATGCAACTCAGAGGCATA -> ATGCAACTCAGAGGCATAG
TACGGTTAGCATAAGTGTA -> ACGGTTAGCATAAGTGTAG
ACCCGTGACGGTCGCCCTC -> CCCGTGACGGTCGCCCTCG
ACCGGCTACACTCGATATG -> CCGGCTACACTCGATATGT
CATAGATCTCGTCAGACCT -> ATAGATCTCGTCAGACCTC
CCTCGAGTAGATATCGAGC -> CTCGAGTAGATATCGAGCT
TACAGTTGGCTTAACGTAA -> ACAGTTGGCTTAACGTAAT
CTTAATAGGCGCACGCTCC -> TTAATAGGCGCACGCTCCC
AGTATATGCGACTTAATTT -> GTATATGCGACTTAATTTG
AACGCTAGCCCTAAGTTCT -> ACGCTAGCCCTAAGTTCTG
ATTCTTTGGTGGGAAGGTT -> TTCTTTGGTGGGAAGGTTA
ACAGTATAGAGTATGGCGG -> CAGTATAGAGTATGGCGGT
TCAGTGTTTTCTTCCCTCT -> CAGTGTTTTCTTCCCTCTA
TCGCGTTTCCGTAAGCCGA -> CGCGTTTCCGTAAGCCGAG
TCCCGCTGTACGGGAGGTG -> CCCGCTGTACGGGAGGTGA
CCCGCGACCCCAGTATTGG -> CCGCGACCCCAGTATTGGT
CTATTGTACGTGAAGGCGC -> TATTGTACGTGAAGGCGCG
AGAGTATATGCGACTTAAT -> GAGTATATGCGACTTAATT
GAGTAGATATCGAGCTTAT -> AGTAGATATCGAGCTTATC
CCTCCCATACCGCCTCGAG -> CTCCCATACCGCCTCGAGT
TGGGCCTGCGTCCAATCGG -> GGGCCTGCGTCCAATCGGA
CCAGCAAAATCTCGAGTGC -> CAGCAAAATCTCGAGTGCC
GCTGAGGGACCGCATAAAC -> CTGAGGGACCGCATAAACC
CCCATACCGCCTCGAGTAG -> CCATACCGCCTCGAGTAGA
CAAAGTCCAACGCCTTTCC -> AAAGTCCAACGCCTTTCCG
GCCTCCGCTAGTTTCACCT -> CCTCCGCTAGTTTCACCTC
GTGCCACGTGACCCAGGTA -> TGCCACGTGACCCAGGTAA
CAGAGTAAGTTTTCCCGAT -> AGAGTAAGTTTTCCCGATG
GTTCTAGTTTCACCTCCTA -> TTCTAGTTTCACCTCCTAT
AGACGCCATCTATCGTAGG -> GACGCCATCTATCGTAGGC
GTACAGTTGGCTTAACGTA -> TACAGTTGGCTTAACGTAA
CAGCTCCGCTAGCGGAACA -> AGCTCCGCTAGCGGAACAG
TTATGTTTGGTCAGACGCC -> TATGTTTGGTCAGACGCCA
CGCCCTCGCCCAAATTTGG -> GCCCTCGCCCAAATTTGGG
CGAGCTTATCGCGAGTCGC -> GAGCTTATCGCGAGTCGCG
GACAGCCCCCGAGCAAGAG -> ACAGCCCCCGAGCAAGAGA
AATCGGCAGGATTGGACTA -> ATCGGCAGGATTGGACTAA
TCTATCGTAGGCTCATCAT -> CTATCGTAGGCTCATCATC
GGCATGTTAAGAAACCTTC -> GCATGTTAAGAAACCTTCC
GACTAATAAGAATTTCAGA -> ACTAATAAGAATTTCAGAA
GGACTCGCCTGGTCGACCG -> GACTCGCCTGGTCGACCGG
TATAGAGTATGGCGGTTGC -> ATAGAGTATGGCGGTTGCC
CCGTGACGGTCGCCCTCGC -> CGTGACGGTCGCCCTCGCC
TGTCCCGACAGCTCCGCTA -> GTCCCGACAGCTCCGCTAG
TGGATCTGAATATCTAAAT -> GGATCTGAATATCTAAATC
AACAGGGTCTTCCCGCTGT -> ACAGGGTCTTCCCGCTGTA
GTCCGGACACCTCCCTATT -> TCCGGACACCTCCCTATTA
TTAGCATAAGTGTAGGTGA -> TAGCATAAGTGTAGGTGAG
CTCCGCTAGCGGAACAGAT -> TCCGCTAGCGGAACAGATG
CCTCGTCTGTTTGTGGTGC -> CTCGTCTGTTTGTGGTGCG
CCGATTTCCTGTGCATAGG -> CGATTTCCTGTGCATAGGC
GCGTTCGGGGCAGTCTCAT -> CGTTCGGGGCAGTCTCATG
TCGAGTAGATATCGAGCTT -> CGAGTAGATATCGAGCTTA
TCGAAATTCAACGCGGTCC -> CGAAATTCAACGCGGTCCG
TAGATGCTTAATAGGCGCA -> AGATGCTTAATAGGCGCAC
GCTGTACGGGAGGTGAATG -> CTGTACGGGAGGTGAATGC
ACTGATATTTGCTATTTGT -> CTGATATTTGCTATTTGTT
CTCCCTATTATTTACGAGG -> TCCCTATTATTTACGAGGT
ACGCTCCCCTACCCGCGAC -> CGCTCCCCTACCCGCGACC
ATTTTGCGTGTTCAACCAT -> TTTTGCGTGTTCAACCATC
TTAGACACTACAGTATAGA -> TAGACACTACAGTATAGAG
CTCCACCATTGGCGATGCT -> TCCACCATTGGCGATGCTC
GCATAAACCACACAGTGGG -> CATAAACCACACAGTGGGA
AGGTACGTCAGGGCTAAGA -> GGTACGTCAGGGCTAAGAC
GTATAAGTGGGCCTGCGTC -> TATAAGTGGGCCTGCGTCC
AGGGACTCGCCTGGTCGAC -> GGGACTCGCCTGGTCGACC
GGAACAGTTTCCACGTAAT -> GAACAGTTTCCACGTAATA
CTGGTAGAATACGGTTAGC -> TGGTAGAATACGGTTAGCA
TGGACGGAGGAGGCTTCCT -> GGACGGAGGAGGCTTCCTT
AAAGTCCAACGCCTTTCCG -> AAGTCCAACGCCTTTCCGC
GCCCATCCCATGGCGACAA -> CCCATCCCATGGCGACAAT
ATACAACAGGGTCTTCCCG -> TACAACAGGGTCTTCCCGC
ACTTAATTTGACCTCCCAT -> CTTAATTTGACCTCCCATA
CACCTCCTATTGTACGTGA -> ACCTCCTATTGTACGTGAA
GTCCGGGCCACCAGATACG -> TCCGGGCCACCAGATACGG
CCAAACTAAGTGTATAAGT -> CAAACTAAGTGTATAAGTG
CTCGCCTGGTCGACCGGCT -> TCGCCTGGTCGACCGGCTA
CCCAAAGGTATAGGACTCA -> CCAAAGGTATAGGACTCAG
AATTTGACCTCCCATACCG -> ATTTGACCTCCCATACCGC
CGGTCGCCCTCGCCCAAAT -> GGTCGCCCTCGCCCAAATT
AAGGGATAGCAAGCGTAGC -> AGGGATAGCAAGCGTAGCA
GGCTTGTGATGAGACAGGC -> GCTTGTGATGAGACAGGCG
TTTCGAAATTCAACGCGGT -> TTCGAAATTCAACGCGGTC
CGCTAGTTTCACCTCCTAT -> GCTAGTTTCACCTCCTATT
GCCAGACACGTATGGTTGC -> CCAGACACGTATGGTTGCA
CCCGAGCAAGAGAAGTGAG -> CCGAGCAAGAGAAGTGAGC
ACACAGTGGGAACCTTCCT -> CACAGTGGGAACCTTCCTC
GCTCCCCTACCCGCGACCC -> CTCCCCTACCCGCGACCCC
ACCTCCTATTGTACGTGAA -> CCTCCTATTGTACGTGAAG
GATTTTGCGTGTTCAACCA -> ATTTTGCGTGTTCAACCAT
ATCCGCAGAATTCTTAAGT -> TCCGCAGAATTCTTAAGTA
ATACGGTAGCCAAGTTCCG -> TACGGTAGCCAAGTTCCGA
TCGGTTCATCCTTAACCCA -> CGGTTCATCCTTAACCCAA
CCGATGGACGGAGGAGGCT -> CGATGGACGGAGGAGGCTT
CTTAAGTAAGCTGGTAGAA -> TTAAGTAAGCTGGTAGAAT
GGACTCAGTGTTTTCTTCC -> GACTCAGTGTTTTCTTCCC
AAGTTCTGGCTCATGCTTT -> AGTTCTGGCTCATGCTTTG
TCCGATTGGCTGGACGGAA -> CCGATTGGCTGGACGGAAC
CACCTCCCCTCATAATCGG -> ACCTCCCCTCATAATCGGC
TTCGTTACAAGAGTCGCGT -> TCGTTACAAGAGTCGCGTT
ATGTTGAGCGCCAGGTCTC -> TGTTGAGCGCCAGGTCTCG
TTGTGATGAGACAGGCGAT -> TGTGATGAGACAGGCGATT
TCTGGCTCATGCTTTGACT -> CTGGCTCATGCTTTGACTC
TGTGCTGCAACACTATCGT -> GTGCTGCAACACTATCGTG
ACTCGCCTGGTCGACCGGC -> CTCGCCTGGTCGACCGGCT
TCCTTAACCCAAAGGTATA -> CCTTAACCCAAAGGTATAG
ACTTTTACATAGATCTCGT -> CTTTTACATAGATCTCGTC
GCGCACGCTCCCCTACCCG -> CGCACGCTCCCCTACCCGC
AACCTTCCACAGACTTTTA -> ACCTTCCACAGACTTTTAC
ACAGAGGCGTAGCCGACCA -> CAGAGGCGTAGCCGACCAG
TACGGTAGCCAAGTTCCGA -> ACGGTAGCCAAGTTCCGAT
AACGGGCCGGGACTTGGGA -> ACGGGCCGGGACTTGGGAA
GGCTACACTCGATATGTTG -> GCTACACTCGATATGTTGA
CGTGTTACCACCCGGTATG -> GTGTTACCACCCGGTATGG
ACTGATTACGCACGTAGTT -> CTGATTACGCACGTAGTTG
TATTCACTAATGTTTCGCG -> ATTCACTAATGTTTCGCGG
TTCCCGCTGTACGGGAGGT -> TCCCGCTGTACGGGAGGTG
ACCAGATACGGTAGCCAAG -> CCAGATACGGTAGCCAAGT
CGAAGTATAAACGGGCCGG -> GAAGTATAAACGGGCCGGG
AGGTGAATGCACCCGTTGT -> GGTGAATGCACCCGTTGTT
AATCCCGTTTTCCACGAGT -> ATCCCGTTTTCCACGAGTT
AATGCGGGTTCGCTGAGGG -> ATGCGGGTTCGCTGAGGGA
TTGAGCGCCAGGTCTCGCC -> TGAGCGCCAGGTCTCGCCG
GGACACCTCCCCGGAGTTG -> GACACCTCCCCGGAGTTGC
TGGTTGCAATCGAGTACTA -> GGTTGCAATCGAGTACTAC
CACTACAGTATAGAGTATG -> ACTACAGTATAGAGTATGG
CCCGTTTTCCACGAGTTAT -> CCGTTTTCCACGAGTTATT
GCCAAGTTCCGATTCCAAA -> CCAAGTTCCGATTCCAAAG
GTGGCGTGACTACGGTGGA -> TGGCGTGACTACGGTGGAT
GACGCCATCTATCGTAGGC -> ACGCCATCTATCGTAGGCT
TCGGATTTGAACTCCTAGT -> CGGATTTGAACTCCTAGTT
TCTATTTTTTGGCATGTTA -> CTATTTTTTGGCATGTTAA
TTGGTGGGAAGGTTATGTA -> TGGTGGGAAGGTTATGTAC
TTCGGGGCAGTCTCATGGG -> TCGGGGCAGTCTCATGGGG
GTGCATAGGCTCTCGATTT -> TGCATAGGCTCTCGATTTG
CCGATTGGCTGGACGGAAC -> CGATTGGCTGGACGGAACA
CCTAATGGGAGGCTGTGGC -> CTAATGGGAGGCTGTGGCG
ACATAGATCTCGTCAGACC -> CATAGATCTCGTCAGACCT
TCGTTACAAGAGTCGCGTT -> CGTTACAAGAGTCGCGTTT
TTTCTTCCCTCTAGGATTT -> TTCTTCCCTCTAGGATTTT
TGCATAGGCTCTCGATTTG -> GCATAGGCTCTCGATTTGC
AGAATTCTTAAGTAAGCTG -> GAATTCTTAAGTAAGCTGG
ATGGACGGAGGAGGCTTCC -> TGGACGGAGGAGGCTTCCT
GTTATGTACTAGGTTCGCC -> TTATGTACTAGGTTCGCCA
GACTGATATTTGCTATTTG -> ACTGATATTTGCTATTTGT
TTCTTCCCTCTAGGATTTT -> TCTTCCCTCTAGGATTTTG
CGTTACAAGAGTCGCGTTT -> GTTACAAGAGTCGCGTTTC
TGGGAACCTTCCTCCACAG -> GGGAACCTTCCTCCACAGT
TAAGTTTTCCCGATGGACG -> AAGTTTTCCCGATGGACGG
CATTGGCGATGCTCTTTGT -> ATTGGCGATGCTCTTTGTC
ACAATCACTGATTACGCAC -> CAATCACTGATTACGCACG
TGCCGGGTCGTCCTTTAAT -> GCCGGGTCGTCCTTTAATA
ATTGGCGATGCTCTTTGTC -> TTGGCGATGCTCTTTGTCC
TTATCGTCCGATTGGCTGG -> TATCGTCCGATTGGCTGGA
TAAGCCGAGCCTCCGCTAG -> AAGCCGAGCCTCCGCTAGT
TACGTCAGGGCTAAGACAT -> ACGTCAGGGCTAAGACATC
GGTGAATGCACCCGTTGTT -> GTGAATGCACCCGTTGTTA
CTATCGTAGGCTCATCATC -> TATCGTAGGCTCATCATCT
ACAGACTTTTACATAGATC -> CAGACTTTTACATAGATCT
ACGTTTAACAATCCCGTTT -> CGTTTAACAATCCCGTTTT
TTAGATGCTTAATAGGCGC -> TAGATGCTTAATAGGCGCA
GTAAACGGACGAGCACAAG -> TAAACGGACGAGCACAAGT
GTTGCAATCGAGTACTACG -> TTGCAATCGAGTACTACGT
ACACTCGATATGTTGAGCG -> CACTCGATATGTTGAGCGC
TAAATACTAGTATTAGCCG -> AAATACTAGTATTAGCCGT
CCAACCGTGCCGGGTCGTC -> CAACCGTGCCGGGTCGTCC
GACGTTAGGACCAACCATC -> ACGTTAGGACCAACCATCC
GACTTTTACATAGATCTCG -> ACTTTTACATAGATCTCGT
TTGTTCGAAGTATAAACGG -> TGTTCGAAGTATAAACGGG
TTTGACTCATCTAGGCGTC -> TTGACTCATCTAGGCGTCT
GCTTAAGGGATAGCAAGCG -> CTTAAGGGATAGCAAGCGT
ATAGAGTATGGCGGTTGCC -> TAGAGTATGGCGGTTGCCC
CGCCTTTCCGCGAGCCTTG -> GCCTTTCCGCGAGCCTTGT
ATACTAGTATTAGCCGTCT -> TACTAGTATTAGCCGTCTT
CTCGCCGACTTCCAGCAAA -> TCGCCGACTTCCAGCAAAA
AGCCTCCGCTAGTTTCACC -> GCCTCCGCTAGTTTCACCT
GATCTCGTCAGACCTCCAC -> ATCTCGTCAGACCTCCACC
GACACTACAGTATAGAGTA -> ACACTACAGTATAGAGTAT
GGACACGCACACACCGTGT -> GACACGCACACACCGTGTG
GTTTCGCGGTCCGGACACC -> TTTCGCGGTCCGGACACCT
GGCCATAATGTACTTATCG -> GCCATAATGTACTTATCGT
CGTTAGGACCAACCATCCG -> GTTAGGACCAACCATCCGC
CTGAGGGGACGTACTGGGT -> TGAGGGGACGTACTGGGTT
GTGGGATGTGTGGTTTAGA -> TGGGATGTGTGGTTTAGAC
CGGCCATAATGTACTTATC -> GGCCATAATGTACTTATCG
CCCGGTATGGGAAGCCAAA -> CCGGTATGGGAAGCCAAAC
TATTATCCTGCTTTACGCG -> ATTATCCTGCTTTACGCGG
TCCCCGGAGTTGCAGGTTC -> CCCCGGAGTTGCAGGTTCT
GGGTTCGTACAGTTGGCTT -> GGTTCGTACAGTTGGCTTA
CAATCCCGTTTTCCACGAG -> AATCCCGTTTTCCACGAGT
CTTGGGAACGCTAGCCCTA -> TTGGGAACGCTAGCCCTAA
AGGTCTCGCCGACTTCCAG -> GGTCTCGCCGACTTCCAGC
AAACGGACGAGCACAAGTT -> AACGGACGAGCACAAGTTA
TACGTTTAACAATCCCGTT -> ACGTTTAACAATCCCGTTT
TTTCTCACCCTACTTACCT -> TTCTCACCCTACTTACCTT
GGATTTTGCGTGTTCAACC -> GATTTTGCGTGTTCAACCA
GCTGCAACACTATCGTGCA -> CTGCAACACTATCGTGCAA
CGCGAGCCTTGTTCGAAGT -> GCGAGCCTTGTTCGAAGTA
TGTCCTGAAAACGCCGTGT -> GTCCTGAAAACGCCGTGTG
CTCATAATCGGCAGGATTG -> TCATAATCGGCAGGATTGG
GTGAGCGCTCGTTGTCAAC -> TGAGCGCTCGTTGTCAACA
TGTTTGGTCAGACGCCATC -> GTTTGGTCAGACGCCATCT
GGTATTGCCGTGGAGCGGA -> GTATTGCCGTGGAGCGGAG
GGTGCGGCTGGCTACTACT -> GTGCGGCTGGCTACTACTG
ATCGGTTCATCCTTAACCC -> TCGGTTCATCCTTAACCCA
ATCTCGAGTGGGATGTGTG -> TCTCGAGTGGGATGTGTGG
TCGTCTGTTTGTGGTGCGG -> CGTCTGTTTGTGGTGCGGC
TCCCATACCGCCTCGAGTA -> CCCATACCGCCTCGAGTAG
GAGGGGACGTACTGGGTTC -> AGGGGACGTACTGGGTTCG
TCGCCCAAATTTGGGCAAT -> CGCCCAAATTTGGGCAATG
CCGGGCCACCAGATACGGT -> CGGGCCACCAGATACGGTA
GTCTTTCCTAATGGGAGGC -> TCTTTCCTAATGGGAGGCT
ATTTGGGCAATGCGGGTTC -> TTTGGGCAATGCGGGTTCG
CACTGGGGTCTTTCCTAAT -> ACTGGGGTCTTTCCTAATG
ATTTGCTATTTGTTCGTTA -> TTTGCTATTTGTTCGTTAC
TTTACATAGATCTCGTCAG -> TTACATAGATCTCGTCAGA
TTCTTTGGTGGGAAGGTTA -> TCTTTGGTGGGAAGGTTAT
ATGTACTTATCGTCCGATT -> TGTACTTATCGTCCGATTG
TTTAACAATCCCGTTTTCC -> TTAACAATCCCGTTTTCCA
CTGCGTCCAATCGGAGGAC -> TGCGTCCAATCGGAGGACC
CAACCGTGCCGGGTCGTCC -> AACCGTGCCGGGTCGTCCT
TCGGCAGGATTGGACTAAT -> CGGCAGGATTGGACTAATA
AGGCGTAGCCGACCAGCCA -> GGCGTAGCCGACCAGCCAG
GTCCAACGCCTTTCCGCGA -> TCCAACGCCTTTCCGCGAG
CAATCGGAGGACCGTATCG -> AATCGGAGGACCGTATCGG
CAGGTCTCGCCGACTTCCA -> AGGTCTCGCCGACTTCCAG
AGGTAACCTGGGGCCTCGT -> GGTAACCTGGGGCCTCGTC
CGTTTCCGTAAGCCGAGCC -> GTTTCCGTAAGCCGAGCCT
TCCACCATTGGCGATGCTC -> CCACCATTGGCGATGCTCT
CGCCATCTATCGTAGGCTC -> GCCATCTATCGTAGGCTCA
TCACTGATTACGCACGTAG -> CACTGATTACGCACGTAGT
AAAAACACCTCACTGGGGT -> AAAACACCTCACTGGGGTC
AACACTAGTTTCACCTCCT -> ACACTAGTTTCACCTCCTA
GGACTAATAAGAATTTCAG -> GACTAATAAGAATTTCAGA
TAGATTACGACTGATATTT -> AGATTACGACTGATATTTG
GATGCTTAATAGGCGCACG -> ATGCTTAATAGGCGCACGC
TGTTTGTGGTGCGGCTGGC -> GTTTGTGGTGCGGCTGGCT
CTACTACTGCCGATTTCCT -> TACTACTGCCGATTTCCTG
CTCGATTGCATTCAGGTAC -> TCGATTGCATTCAGGTACG
TACAACAGGGTCTTCCCGC -> ACAACAGGGTCTTCCCGCT
GTTAAGAAACCTTCCACAG -> TTAAGAAACCTTCCACAGA
ATTTCTCACCCTACTTACC -> TTTCTCACCCTACTTACCT
ACGGACGAGCACAAGTTAC -> CGGACGAGCACAAGTTACA
TTCAACGCGGTCCGGACAC -> TCAACGCGGTCCGGACACC
TAAGAATTTCAGAAAAACA -> AAGAATTTCAGAAAAACAC
AAGGTATAGGACTCAGTGT -> AGGTATAGGACTCAGTGTT
CTGAGGGACCGCATAAACC -> TGAGGGACCGCATAAACCA
ATCGAGTACTACGTTTAAC -> TCGAGTACTACGTTTAACA
CTCTCGATTTGCGTTCGGG -> TCTCGATTTGCGTTCGGGG
TAGCCAAGTTCCGATTCCA -> AGCCAAGTTCCGATTCCAA
CCTGCTTTACGCGGTCCGG -> CTGCTTTACGCGGTCCGGA
GGTCGACCGGCTACACTCG -> GTCGACCGGCTACACTCGA
GTTTTCTTCCCTCTAGGAT -> TTTTCTTCCCTCTAGGATT
GCTTTACGCGGTCCGGACA -> CTTTACGCGGTCCGGACAC
ACACTACAGTATAGAGTAT -> CACTACAGTATAGAGTATG
GCAAACAGAGGCGTAGCCG -> CAAACAGAGGCGTAGCCGA
TGTTCTAGTTTCACCTCCT -> GTTCTAGTTTCACCTCCTA
ACTAGGTTCGCCAAAGACG -> CTAGGTTCGCCAAAGACGA
ACTCCTAGTTTCACCTCCT -> CTCCTAGTTTCACCTCCTA
TGTTAAGAAACCTTCCACA -> GTTAAGAAACCTTCCACAG
CCCGACAGCTCCGCTAGCG -> CCGACAGCTCCGCTAGCGG
GACCTGTTGAACACGTGTG -> ACCTGTTGAACACGTGTGC
TTTTACATAGATCTCGTCA -> TTTACATAGATCTCGTCAG
GGCTCTCGATTTGCGTTCG -> GCTCTCGATTTGCGTTCGG
GAGGCTGTGGCGTGACTAC -> AGGCTGTGGCGTGACTACG
TACGCACGTAGTTGATGAG -> ACGCACGTAGTTGATGAGC
GAGGTTGTCCTGAAAACGC -> AGGTTGTCCTGAAAACGCC
CACTGATTACGCACGTAGT -> ACTGATTACGCACGTAGTT
GCAACTCAGAGGCATAGAG -> CAACTCAGAGGCATAGAGT
CTATTTCGAAATTCAACGC -> TATTTCGAAATTCAACGCG
CTAGGCGTCTATTTTTTGG -> TAGGCGTCTATTTTTTGGC
TAATAGGCGCACGCTCCCC -> AATAGGCGCACGCTCCCCT
ATTATCCTGCTTTACGCGG -> TTATCCTGCTTTACGCGGT
TCTCTTCCGAGCTTAAGGG -> CTCTTCCGAGCTTAAGGGA
CGTCCGATTGGCTGGACGG -> GTCCGATTGGCTGGACGGA
GAGAAGTGAGCGCTCGTTG -> AGAAGTGAGCGCTCGTTGT
CATGGCGACAATCACTGAT -> ATGGCGACAATCACTGATT
AGGTTGTCCTGAAAACGCC -> GGTTGTCCTGAAAACGCCG
CCCTACTTACCTTGAGACC -> CCTACTTACCTTGAGACCT
ATGGCGGTTGCCCTCGATT -> TGGCGGTTGCCCTCGATTG
CTACGTTTAACAATCCCGT -> TACGTTTAACAATCCCGTT
CCCTCATAATCGGCAGGAT -> CCTCATAATCGGCAGGATT
GGAACGCTAGCCCTAAGTT -> GAACGCTAGCCCTAAGTTC
AGCAAGCGTAGCACGATGG -> GCAAGCGTAGCACGATGGT
AGATGTAAACGGACGAGCA -> GATGTAAACGGACGAGCAC
TGGTCAGACGCCATCTATC -> GGTCAGACGCCATCTATCG
GGTCTTTCCTAATGGGAGG -> GTCTTTCCTAATGGGAGGC
TTAACAATCCCGTTTTCCA -> TAACAATCCCGTTTTCCAC
CCGATTCCAAAGTCATGCA -> CGATTCCAAAGTCATGCAA
ACGGGAGGTGAATGCACCC -> CGGGAGGTGAATGCACCCG
CCATCCGCAGAATTCTTAA -> CATCCGCAGAATTCTTAAG
TCGTACAGTTGGCTTAACG -> CGTACAGTTGGCTTAACGT
CCTGTTGAACACGTGTGCT -> CTGTTGAACACGTGTGCTG
TAATAAGAATTTCAGAAAA -> AATAAGAATTTCAGAAAAA
CCTAGTTTCACCTCCTATT -> CTAGTTTCACCTCCTATTC
TTCACCTCCTATTGTACGT -> TCACCTCCTATTGTACGTG
AACGCCGTGTGCTTCTCCG -> ACGCCGTGTGCTTCTCCGA
CGATTTCCTGTGCATAGGC -> GATTTCCTGTGCATAGGCT
TATCGTCCGATTGGCTGGA -> ATCGTCCGATTGGCTGGAC
ATAATCGGATTTGAACTCC -> TAATCGGATTTGAACTCCT
TTTGGCATGTTAAGAAACC -> TTGGCATGTTAAGAAACCT
AGGTTATGTACTAGGTTCG -> GGTTATGTACTAGGTTCGC
CCTTTAATACTCTCTTCCG -> CTTTAATACTCTCTTCCGA
GTATAGGTATAGGGACTCG -> TATAGGTATAGGGACTCGC
TGCACCCGTTGTTATGTTT -> GCACCCGTTGTTATGTTTG
GATTACGACTGATATTTGC -> ATTACGACTGATATTTGCT
AGTTTCACCTCCTATTGTA -> GTTTCACCTCCTATTGTAC
GCGACTTAATTTGACCTCC -> CGACTTAATTTGACCTCCC
CTGAAAACGCCGTGTGCTT -> TGAAAACGCCGTGTGCTTC
CTTTTACATAGATCTCGTC -> TTTTACATAGATCTCGTCA
GCTGAGGGGACGTACTGGG -> CTGAGGGGACGTACTGGGT
CATTCTTTGGTGGGAAGGT -> ATTCTTTGGTGGGAAGGTT
CACTATCGTGCAAACAGAG -> ACTATCGTGCAAACAGAGG
GGTCGTCCTTTAATACTCT -> GTCGTCCTTTAATACTCTC
GAATTTCAGAAAAACACCT -> AATTTCAGAAAAACACCTC
GATTGGACTAATAAGAATT -> ATTGGACTAATAAGAATTT
TGTGGTGCGGCTGGCTACT -> GTGGTGCGGCTGGCTACTA
TTAATAGGCGCACGCTCCC -> TAATAGGCGCACGCTCCCC
AATTGTGTAACCCGTGACG -> ATTGTGTAACCCGTGACGG
CTGGCTACTACTGCCGATT -> TGGCTACTACTGCCGATTT
CGCGTTTCCGTAAGCCGAG -> GCGTTTCCGTAAGCCGAGC
CGGAGTTGCAGGTTCTCCC -> GGAGTTGCAGGTTCTCCCA
TCCAAAGTCATGCAACTCA -> CCAAAGTCATGCAACTCAG
TTCACCTCCTATTCACTAA -> TCACCTCCTATTCACTAAT
GGACACCTCCCTAAATATT -> GACACCTCCCTAAATATTA
TAAGGGATAGCAAGCGTAG -> AAGGGATAGCAAGCGTAGC
CCTGCGTCCAATCGGAGGA -> CTGCGTCCAATCGGAGGAC
CTTATCGCGAGTCGCGGTA -> TTATCGCGAGTCGCGGTAT
CTTTGGTGGGAAGGTTATG -> TTTGGTGGGAAGGTTATGT
CCGCAGAATTCTTAAGTAA -> CGCAGAATTCTTAAGTAAG
TCCAATCGGAGGACCGTAT -> CCAATCGGAGGACCGTATC
CGTGTGCCACGTGACCCAG -> GTGTGCCACGTGACCCAGG
GCTCTTTGTCCCGACAGCT -> CTCTTTGTCCCGACAGCTC
AAGCCGAGCCTCCGCTAGT -> AGCCGAGCCTCCGCTAGTT
TGCCACGTGACCCAGGTAA -> GCCACGTGACCCAGGTAAC
AGTGGATCTGAATATCTAA -> GTGGATCTGAATATCTAAA
ACAACAGGGTCTTCCCGCT -> CAACAGGGTCTTCCCGCTG
CTAAATCGTGTTACCACCC -> TAAATCGTGTTACCACCCG
AGTAAGTTTTCCCGATGGA -> GTAAGTTTTCCCGATGGAC
TCAGAAAAACACCTCACTG -> CAGAAAAACACCTCACTGG
CCGGTATGGGAAGCCAAAC -> CGGTATGGGAAGCCAAACT
TTGCGTTCGGGGCAGTCTC -> TGCGTTCGGGGCAGTCTCA
TTGCGTGTTCAACCATCCC -> TGCGTGTTCAACCATCCCG
CGTCAGGGCTAAGACATCG -> GTCAGGGCTAAGACATCGT
GTCCGGACACCTCCCTAAA -> TCCGGACACCTCCCTAAAT
CGTATCGGCTAGATTACGA -> GTATCGGCTAGATTACGAC
GCCATCTATCGTAGGCTCA -> CCATCTATCGTAGGCTCAT
CATCGGTTCATCCTTAACC -> ATCGGTTCATCCTTAACCC
TAATTTGACCTCCCATACC -> AATTTGACCTCCCATACCG
GCCGTGTGCTTCTCCGAAA -> CCGTGTGCTTCTCCGAAAA
CCACCATTGGCGATGCTCT -> CACCATTGGCGATGCTCTT
GCGGAACAGATGTAAACGG -> CGGAACAGATGTAAACGGA
GGCCTGCGTCCAATCGGAG -> GCCTGCGTCCAATCGGAGG
TGAATGCACCCGTTGTTAT -> GAATGCACCCGTTGTTATG
CCAGGTCTCGCCGACTTCC -> CAGGTCTCGCCGACTTCCA
TGGGAAGCCAAACTAAGTG -> GGGAAGCCAAACTAAGTGT
CCGGACACCTCCCCTCATA -> CGGACACCTCCCCTCATAA
GCCATAATGTACTTATCGT -> CCATAATGTACTTATCGTC
GTTTCACCTCCTATTATCC -> TTTCACCTCCTATTATCCT
ACACCTCCCCGGAGTTGCA -> CACCTCCCCGGAGTTGCAG
CAAATTTGGGCAATGCGGG -> AAATTTGGGCAATGCGGGT
GTGAAGGCGCGGTCCGGAC -> TGAAGGCGCGGTCCGGACA
CAATCGGGCAACACTAGTT -> AATCGGGCAACACTAGTTT
ACATTCTTTGGTGGGAAGG -> CATTCTTTGGTGGGAAGGT
CTCATGGGGCAGAGTAAGT -> TCATGGGGCAGAGTAAGTT
GTAGTTGATGAGCGTCCGG -> TAGTTGATGAGCGTCCGGG
TCGACCGGCTACACTCGAT -> CGACCGGCTACACTCGATA
CGCCTCGAGTAGATATCGA -> GCCTCGAGTAGATATCGAG
TGGCGGTTGCCCTCGATTG -> GGCGGTTGCCCTCGATTGC
AGAGGCATAGAGTATATGC -> GAGGCATAGAGTATATGCG
ACAGATGTAAACGGACGAG -> CAGATGTAAACGGACGAGC
ATAATCGGCAGGATTGGAC -> TAATCGGCAGGATTGGACT
AGCTGGTAGAATACGGTTA -> GCTGGTAGAATACGGTTAG
TTGACTCATCTAGGCGTCT -> TGACTCATCTAGGCGTCTA
GCAGGTTCTCCCATCGGTT -> CAGGTTCTCCCATCGGTTC
GAGGTGAATGCACCCGTTG -> AGGTGAATGCACCCGTTGT
TACGAGGTTGTCCTGAAAA -> ACGAGGTTGTCCTGAAAAC
CGGGCAACACTAGTTTCAC -> GGGCAACACTAGTTTCACC
CTTCCCTCTAGGATTTTGC -> TTCCCTCTAGGATTTTGCG
CAAACAGAGGCGTAGCCGA -> AAACAGAGGCGTAGCCGAC
AAACGCCGTGTGCTTCTCC -> AACGCCGTGTGCTTCTCCG
AAACCTTCCACAGACTTTT -> AACCTTCCACAGACTTTTA
GAGCGTCCGGGCCACCAGA -> AGCGTCCGGGCCACCAGAT
GACTTGGGAACGCTAGCCC -> ACTTGGGAACGCTAGCCCT
GGTCCGGACACCTCCCCGG -> GTCCGGACACCTCCCCGGA
CACCTCCCCGGAGTTGCAG -> ACCTCCCCGGAGTTGCAGG
TGTGTGGTTTAGACACTAC -> GTGTGGTTTAGACACTACA
GTCCGATTGGCTGGACGGA -> TCCGATTGGCTGGACGGAA
AATGCACCCGTTGTTATGT -> ATGCACCCGTTGTTATGTT
TCTTCCCTCTAGGATTTTG -> CTTCCCTCTAGGATTTTGC
CGTCTGTTTGTGGTGCGGC -> GTCTGTTTGTGGTGCGGCT
TTGAACACGTGTGCTGCAA -> TGAACACGTGTGCTGCAAC
CAGCCCCCGAGCAAGAGAA -> AGCCCCCGAGCAAGAGAAG
AAACGGGCCGGGACTTGGG -> AACGGGCCGGGACTTGGGA
TGAATAAATACTAGTATTA -> GAATAAATACTAGTATTAG
TCGCGGTATTGCCGTGGAG -> CGCGGTATTGCCGTGGAGC
CCCATGGCGACAATCACTG -> CCATGGCGACAATCACTGA
TGTATAAGTGGGCCTGCGT -> GTATAAGTGGGCCTGCGTC
TAATATACAACAGGGTCTT -> AATATACAACAGGGTCTTC
CTAGCCCTAAGTTCTGGCT -> TAGCCCTAAGTTCTGGCTC
AGGCTGTGGCGTGACTACG -> GGCTGTGGCGTGACTACGG
AGTGGGAACCTTCCTCCAC -> GTGGGAACCTTCCTCCACA
GAACAGATGTAAACGGACG -> AACAGATGTAAACGGACGA
TTTGAACTCCTAGTTTCAC -> TTGAACTCCTAGTTTCACC
GACCAGCCAGACACGTATG -> ACCAGCCAGACACGTATGG
TTGGCTGGACGGAACAGTT -> TGGCTGGACGGAACAGTTT
GCTCATCATCTCGAGTGGG -> CTCATCATCTCGAGTGGGA
GGGGCAGTCTCATGGGGCA -> GGGCAGTCTCATGGGGCAG
TGGTGCGGCTGGCTACTAC -> GGTGCGGCTGGCTACTACT
GGACATTCTTTGGTGGGAA -> GACATTCTTTGGTGGGAAG
TTAATACTCTCTTCCGAGC -> TAATACTCTCTTCCGAGCT
ACGTGACCCAGGTAACCTG -> CGTGACCCAGGTAACCTGG
TATCGTAGGCTCATCATCT -> ATCGTAGGCTCATCATCTC
ATAGCAAGCGTAGCACGAT -> TAGCAAGCGTAGCACGATG
TCTCCCATCGGTTCATCCT -> CTCCCATCGGTTCATCCTT
TTCCAAAGTCATGCAACTC -> TCCAAAGTCATGCAACTCA
AGCCCTAAGTTCTGGCTCA -> GCCCTAAGTTCTGGCTCAT
CTAAGTGTATAAGTGGGCC -> TAAGTGTATAAGTGGGCCT
GCACGCTCCCCTACCCGCG -> CACGCTCCCCTACCCGCGA
GGGCCTCGTCTGTTTGTGG -> GGCCTCGTCTGTTTGTGGT
TTTGCGTGTTCAACCATCC -> TTGCGTGTTCAACCATCCC
GCCAGGTCTCGCCGACTTC -> CCAGGTCTCGCCGACTTCC
CCATACCGCCTCGAGTAGA -> CATACCGCCTCGAGTAGAT
CATTCAGGTACGTCAGGGC -> ATTCAGGTACGTCAGGGCT
CTAGGTTCGCCAAAGACGA -> TAGGTTCGCCAAAGACGAG
AATTTGGGCAATGCGGGTT -> ATTTGGGCAATGCGGGTTC
CGTGCAAACAGAGGCGTAG -> GTGCAAACAGAGGCGTAGC
AGCGCCAGGTCTCGCCGAC -> GCGCCAGGTCTCGCCGACT
GGGCAACACTAGTTTCACC -> GGCAACACTAGTTTCACCT
TCCGCGAGCCTTGTTCGAA -> CCGCGAGCCTTGTTCGAAG
CACGATGGTAACCTCTCTC -> ACGATGGTAACCTCTCTCC
ATTGCCGTGGAGCGGAGAT -> TTGCCGTGGAGCGGAGATG
ATGGGGCAGAGTAAGTTTT -> TGGGGCAGAGTAAGTTTTC
ACGAGGTTGTCCTGAAAAC -> CGAGGTTGTCCTGAAAACG
TGTTTCGCGGTCCGGACAC -> GTTTCGCGGTCCGGACACC
CGCCAGGTCTCGCCGACTT -> GCCAGGTCTCGCCGACTTC
CCAGCCAGACACGTATGGT -> CAGCCAGACACGTATGGTT
TACACGGCTGAGGGGACGT -> ACACGGCTGAGGGGACGTA
TTGCCCTCGATTGCATTCA -> TGCCCTCGATTGCATTCAG
TTCCGTAAGCCGAGCCTCC -> TCCGTAAGCCGAGCCTCCG
CAGAATTCTTAAGTAAGCT -> AGAATTCTTAAGTAAGCTG
GGAACCTTCCTCCACAGTG -> GAACCTTCCTCCACAGTGG
GGACGGAGGAGGCTTCCTT -> GACGGAGGAGGCTTCCTTA
TCCCGACAGCTCCGCTAGC -> CCCGACAGCTCCGCTAGCG
AAGTCCAACGCCTTTCCGC -> AGTCCAACGCCTTTCCGCG
TTACAAGAGTCGCGTTTCC -> TACAAGAGTCGCGTTTCCG
TCCCGGCCATAATGTACTT -> CCCGGCCATAATGTACTTA
GGGGCAGAGTAAGTTTTCC -> GGGCAGAGTAAGTTTTCCC
GAGCTTAAGGGATAGCAAG -> AGCTTAAGGGATAGCAAGC
CATCCCGGCCATAATGTAC -> ATCCCGGCCATAATGTACT
CGTGCCGGGTCGTCCTTTA -> GTGCCGGGTCGTCCTTTAA
ATTCAACGCGGTCCGGACA -> TTCAACGCGGTCCGGACAC
AGTACTACGTTTAACAATC -> GTACTACGTTTAACAATCC
GGACGGAACAGTTTCCACG -> GACGGAACAGTTTCCACGT
CTCCCCTACCCGCGACCCC -> TCCCCTACCCGCGACCCCA
CCAAAGTCATGCAACTCAG -> CAAAGTCATGCAACTCAGA
AAGCGTAGCACGATGGTAA -> AGCGTAGCACGATGGTAAC
GCAAGAGAAGTGAGCGCTC -> CAAGAGAAGTGAGCGCTCG
TATATGCGACTTAATTTGA -> ATATGCGACTTAATTTGAC
CGACAATCACTGATTACGC -> GACAATCACTGATTACGCA
ATCGGAGGACCGTATCGGC -> TCGGAGGACCGTATCGGCT
CGTCCCAACCGTGCCGGGT -> GTCCCAACCGTGCCGGGTC
GTGCGGCTGGCTACTACTG -> TGCGGCTGGCTACTACTGC
CGGACACCTCCCCTCATAA -> GGACACCTCCCCTCATAAT
TCCATGACAGCCCCCGAGC -> CCATGACAGCCCCCGAGCA
GGGAGGCTGTGGCGTGACT -> GGAGGCTGTGGCGTGACTA
ACGCACACACCGTGTGCCA -> CGCACACACCGTGTGCCAC
TGGGATGTGTGGTTTAGAC -> GGGATGTGTGGTTTAGACA
TTCTTAAGTAAGCTGGTAG -> TCTTAAGTAAGCTGGTAGA
GGCGTAGCCGACCAGCCAG -> GCGTAGCCGACCAGCCAGA
GAACCTTCCTCCACAGTGG -> AACCTTCCTCCACAGTGGA
ATAATGTACTTATCGTCCG -> TAATGTACTTATCGTCCGA
AGCAAGAGAAGTGAGCGCT -> GCAAGAGAAGTGAGCGCTC
TTATGTACTAGGTTCGCCA -> TATGTACTAGGTTCGCCAA
TATTGGTTATGAATAAATA -> ATTGGTTATGAATAAATAC
ATTGTTCTAGTTTCACCTC -> TTGTTCTAGTTTCACCTCC
AATGTACTTATCGTCCGAT -> ATGTACTTATCGTCCGATT
AGGCTCTCGATTTGCGTTC -> GGCTCTCGATTTGCGTTCG
CTTTCCTAATGGGAGGCTG -> TTTCCTAATGGGAGGCTGT
TTACAATCGGGCAACACTA -> TACAATCGGGCAACACTAG
GTGTAACCCGTGACGGTCG -> TGTAACCCGTGACGGTCGC
AAACTAAGTGTATAAGTGG -> AACTAAGTGTATAAGTGGG
GTTTCACCTCCTATTGTAC -> TTTCACCTCCTATTGTACG
TGACTCATCTAGGCGTCTA -> GACTCATCTAGGCGTCTAT
GGTAACCTCTCTCCGACGG -> GTAACCTCTCTCCGACGGC
CGCTGAGGGACCGCATAAA -> GCTGAGGGACCGCATAAAC
TAGGCGTCTATTTTTTGGC -> AGGCGTCTATTTTTTGGCA
TCGATTTGCGTTCGGGGCA -> CGATTTGCGTTCGGGGCAG
CTCACCCTACTTACCTTGA -> TCACCCTACTTACCTTGAG
TGGTGGGAAGGTTATGTAC -> GGTGGGAAGGTTATGTACT
TCCGGACACCTCCCCGGAG -> CCGGACACCTCCCCGGAGT
CCTCCACAGTGGATCTGAA -> CTCCACAGTGGATCTGAAT
CGGTATTGCCGTGGAGCGG -> GGTATTGCCGTGGAGCGGA
GGGACCGCATAAACCACAC -> GGACCGCATAAACCACACA
CTAAATATTAGATGCTTAA -> TAAATATTAGATGCTTAAT
AACAATCCCGTTTTCCACG -> ACAATCCCGTTTTCCACGA
TTGGGCAATGCGGGTTCGC -> TGGGCAATGCGGGTTCGCT
GTACGGGAGGTGAATGCAC -> TACGGGAGGTGAATGCACC
CATGCTTTGACTCATCTAG -> ATGCTTTGACTCATCTAGG
CTCCCATCGGTTCATCCTT -> TCCCATCGGTTCATCCTTA
TGAACACGTGTGCTGCAAC -> GAACACGTGTGCTGCAACA
ATCGGCTAGATTACGACTG -> TCGGCTAGATTACGACTGA
GTATGGTTGCAATCGAGTA -> TATGGTTGCAATCGAGTAC
TTGTTCGTTACAAGAGTCG -> TGTTCGTTACAAGAGTCGC
CTTTCCGCGAGCCTTGTTC -> TTTCCGCGAGCCTTGTTCG
TAGGTGAGGACATTCTTTG -> AGGTGAGGACATTCTTTGG
GCTACACTCGATATGTTGA -> CTACACTCGATATGTTGAG
CCTCATAATCGGCAGGATT -> CTCATAATCGGCAGGATTG
CGGTTGCCCTCGATTGCAT -> GGTTGCCCTCGATTGCATT
CATCTAGGCGTCTATTTTT -> ATCTAGGCGTCTATTTTTT
TAGGTATAGGGACTCGCCT -> AGGTATAGGGACTCGCCTG
TACGGTGGATCGTCCCAAC -> ACGGTGGATCGTCCCAACC
AACCACACAGTGGGAACCT -> ACCACACAGTGGGAACCTT
CCTCACTGGGGTCTTTCCT -> CTCACTGGGGTCTTTCCTA
TCATGCAACTCAGAGGCAT -> CATGCAACTCAGAGGCATA
TCGAGTGGGATGTGTGGTT -> CGAGTGGGATGTGTGGTTT
TATCTAAATCGTGTTACCA -> ATCTAAATCGTGTTACCAC
GTGTTACCACCCGGTATGG -> TGTTACCACCCGGTATGGG
GTTAGGACCAACCATCCGC -> TTAGGACCAACCATCCGCA
TTCTCACCCTACTTACCTT -> TCTCACCCTACTTACCTTG
CGCGACCCCAGTATTGGTT -> GCGACCCCAGTATTGGTTA
GACATCGTATAGGTATAGG -> ACATCGTATAGGTATAGGG
CCTATTATTTACGAGGTTG -> CTATTATTTACGAGGTTGT
GTTGATGAGCGTCCGGGCC -> TTGATGAGCGTCCGGGCCA
TCCGTAAGCCGAGCCTCCG -> CCGTAAGCCGAGCCTCCGC
CCTATTCACTAATGTTTCG -> CTATTCACTAATGTTTCGC
CAGTTGGCTTAACGTAATG -> AGTTGGCTTAACGTAATGG
TGTGGTTTAGACACTACAG -> GTGGTTTAGACACTACAGT
CGCAGAATTCTTAAGTAAG -> GCAGAATTCTTAAGTAAGC
AATCGGAGGACCGTATCGG -> ATCGGAGGACCGTATCGGC
TAATGTTTCGCGGTCCGGA -> AATGTTTCGCGGTCCGGAC
ACCGTATCGGCTAGATTAC -> CCGTATCGGCTAGATTACG
GGCTGGCTACTACTGCCGA -> GCTGGCTACTACTGCCGAT
CGTCTTGGAAGCCTACACG -> GTCTTGGAAGCCTACACGG
CACACCGTGTGCCACGTGA -> ACACCGTGTGCCACGTGAC
GTTTGTGGTGCGGCTGGCT -> TTTGTGGTGCGGCTGGCTA
ATATACAACAGGGTCTTCC -> TATACAACAGGGTCTTCCC
AATGGGAGGCTGTGGCGTG -> ATGGGAGGCTGTGGCGTGA
TGATGAGACAGGCGATTTC -> GATGAGACAGGCGATTTCT
GCGGTATTGCCGTGGAGCG -> CGGTATTGCCGTGGAGCGG
GCCCCCGAGCAAGAGAAGT -> CCCCCGAGCAAGAGAAGTG
ACGTAGTTGATGAGCGTCC -> CGTAGTTGATGAGCGTCCG
CTCCCTAAATATTAGATGC -> TCCCTAAATATTAGATGCT
GACATTCTTTGGTGGGAAG -> ACATTCTTTGGTGGGAAGG
TAAACCACACAGTGGGAAC -> AAACCACACAGTGGGAACC
AGAGTAAGTTTTCCCGATG -> GAGTAAGTTTTCCCGATGG
AGCCAAGTTCCGATTCCAA -> GCCAAGTTCCGATTCCAAA
GGATCTGAATATCTAAATC -> GATCTGAATATCTAAATCG
CAACACTATCGTGCAAACA -> AACACTATCGTGCAAACAG
CGATTGGCTGGACGGAACA -> GATTGGCTGGACGGAACAG
CAGGTTCTCCCATCGGTTC -> AGGTTCTCCCATCGGTTCA
AGGACCAACCATCCGCAGA -> GGACCAACCATCCGCAGAA
GCGATTTCTCACCCTACTT -> CGATTTCTCACCCTACTTA
GCACACACCGTGTGCCACG -> CACACACCGTGTGCCACGT
CATCTCGAGTGGGATGTGT -> ATCTCGAGTGGGATGTGTG
GTCCTGAAAACGCCGTGTG -> TCCTGAAAACGCCGTGTGC
GTAGGTGAGGACATTCTTT -> TAGGTGAGGACATTCTTTG
GGGCAATGCGGGTTCGCTG -> GGCAATGCGGGTTCGCTGA
GGATTGGACTAATAAGAAT -> GATTGGACTAATAAGAATT
GTCCCGACAGCTCCGCTAG -> TCCCGACAGCTCCGCTAGC
CGGGCCACCAGATACGGTA -> GGGCCACCAGATACGGTAG
GCCGACCAGCCAGACACGT -> CCGACCAGCCAGACACGTA
GGCGCGGTCCGGACACCTC -> GCGCGGTCCGGACACCTCC
ACGCCTTTCCGCGAGCCTT -> CGCCTTTCCGCGAGCCTTG
TACATAGATCTCGTCAGAC -> ACATAGATCTCGTCAGACC
AGATTACGACTGATATTTG -> GATTACGACTGATATTTGC
GTTATGTTTGGTCAGACGC -> TTATGTTTGGTCAGACGCC
GCAATGCGGGTTCGCTGAG -> CAATGCGGGTTCGCTGAGG
CGAGCAAGAGAAGTGAGCG -> GAGCAAGAGAAGTGAGCGC
CAACTCAGAGGCATAGAGT -> AACTCAGAGGCATAGAGTA
GGTTCGCCAAAGACGAGGC -> GTTCGCCAAAGACGAGGCA
TATTATTTACGAGGTTGTC -> ATTATTTACGAGGTTGTCC
TATCGAGCTTATCGCGAGT -> ATCGAGCTTATCGCGAGTC
GCGTCCAATCGGAGGACCG -> CGTCCAATCGGAGGACCGT
CTTTACGCGGTCCGGACAC -> TTTACGCGGTCCGGACACC
GGCGATGCTCTTTGTCCCG -> GCGATGCTCTTTGTCCCGA
CTAGGATTTTGCGTGTTCA -> TAGGATTTTGCGTGTTCAA
CGTCTATTTTTTGGCATGT -> GTCTATTTTTTGGCATGTT
ACACTAGTTTCACCTCCTA -> CACTAGTTTCACCTCCTAT
GCTGGTAGAATACGGTTAG -> CTGGTAGAATACGGTTAGC
TTTAGACACTACAGTATAG -> TTAGACACTACAGTATAGA
GGCCTCGTCTGTTTGTGGT -> GCCTCGTCTGTTTGTGGTG
CCTGTGCATAGGCTCTCGA -> CTGTGCATAGGCTCTCGAT
AATATACAACAGGGTCTTC -> ATATACAACAGGGTCTTCC
CGGTAGCCAAGTTCCGATT -> GGTAGCCAAGTTCCGATTC
ACCGCATAAACCACACAGT -> CCGCATAAACCACACAGTG
AGCGTCCGGGCCACCAGAT -> GCGTCCGGGCCACCAGATA
AGATGCTTAATAGGCGCAC -> GATGCTTAATAGGCGCACG
ACTAAGTGTATAAGTGGGC -> CTAAGTGTATAAGTGGGCC
GTGGGCCTGCGTCCAATCG -> TGGGCCTGCGTCCAATCGG
CTACTTACCTTGAGACCTG -> TACTTACCTTGAGACCTGT
TGGTTATGAATAAATACTA -> GGTTATGAATAAATACTAG
CTGTTGAACACGTGTGCTG -> TGTTGAACACGTGTGCTGC
GGACGAGCACAAGTTACAA -> GACGAGCACAAGTTACAAT
GGAACAGATGTAAACGGAC -> GAACAGATGTAAACGGACG
CTCGTCAGACCTCCACCAT -> TCGTCAGACCTCCACCATT
GAGGAGGCTTCCTTAATTG -> AGGAGGCTTCCTTAATTGT
GAAAAACACCTCACTGGGG -> AAAAACACCTCACTGGGGT
TCGCCTGGTCGACCGGCTA -> CGCCTGGTCGACCGGCTAC
GATTCCAAAGTCATGCAAC -> ATTCCAAAGTCATGCAACT
TCATAATCGGCAGGATTGG -> CATAATCGGCAGGATTGGA
CATAATGTACTTATCGTCC -> ATAATGTACTTATCGTCCG
GGACACCTCCCTATTATTT -> GACACCTCCCTATTATTTA
CCGTTGTTATGTTTGGTCA -> CGTTGTTATGTTTGGTCAG
CTGTGCATAGGCTCTCGAT -> TGTGCATAGGCTCTCGATT
GCATAGGCTCTCGATTTGC -> CATAGGCTCTCGATTTGCG
ATTGGTTATGAATAAATAC -> TTGGTTATGAATAAATACT
CTGCAACACTATCGTGCAA -> TGCAACACTATCGTGCAAA
CTTCCCGCTGTACGGGAGG -> TTCCCGCTGTACGGGAGGT
CAAACTAAGTGTATAAGTG -> AAACTAAGTGTATAAGTGG
ACACCTCCCTATTATTTAC -> CACCTCCCTATTATTTACG
CGTACTGGGTTCGTACAGT -> GTACTGGGTTCGTACAGTT
AGAATACGGTTAGCATAAG -> GAATACGGTTAGCATAAGT
TCACCTCCTATTATCCTGC -> CACCTCCTATTATCCTGCT
TACCCGCGACCCCAGTATT -> ACCCGCGACCCCAGTATTG
CGCTGTACGGGAGGTGAAT -> GCTGTACGGGAGGTGAATG
GTACGTCAGGGCTAAGACA -> TACGTCAGGGCTAAGACAT
TAGTTGATGAGCGTCCGGG -> AGTTGATGAGCGTCCGGGC
ACGGAACAGTTTCCACGTA -> CGGAACAGTTTCCACGTAA
TAGGTTCGCCAAAGACGAG -> AGGTTCGCCAAAGACGAGG
CGATGGTAACCTCTCTCCG -> GATGGTAACCTCTCTCCGA
CCGAGCAAGAGAAGTGAGC -> CGAGCAAGAGAAGTGAGCG
CAACAAAGTCCAACGCCTT -> AACAAAGTCCAACGCCTTT
TCATCTAGGCGTCTATTTT -> CATCTAGGCGTCTATTTTT
AGTTACAATCGGGCAACAC -> GTTACAATCGGGCAACACT
CTACACGGCTGAGGGGACG -> TACACGGCTGAGGGGACGT
GGCAGAGTAAGTTTTCCCG -> GCAGAGTAAGTTTTCCCGA
CCTGGTCGACCGGCTACAC -> CTGGTCGACCGGCTACACT
AAAATCTCGAGTGCCCATC -> AAATCTCGAGTGCCCATCC
TGACGGTCGCCCTCGCCCA -> GACGGTCGCCCTCGCCCAA
GGCAGTCTCATGGGGCAGA -> GCAGTCTCATGGGGCAGAG
TTCCTAATGGGAGGCTGTG -> TCCTAATGGGAGGCTGTGG
ACGAGTTATTGTTCTAGTT -> CGAGTTATTGTTCTAGTTT
AACGCGGTCCGGACACCTC -> ACGCGGTCCGGACACCTCC
TAATGTACTTATCGTCCGA -> AATGTACTTATCGTCCGAT
TAATGGGAGGCTGTGGCGT -> AATGGGAGGCTGTGGCGTG
CCTACTTACCTTGAGACCT -> CTACTTACCTTGAGACCTG
GTCCCAACCGTGCCGGGTC -> TCCCAACCGTGCCGGGTCG
ATTATTTACGAGGTTGTCC -> TTATTTACGAGGTTGTCCT
CGCACGCTCCCCTACCCGC -> GCACGCTCCCCTACCCGCG
AGTCTCATGGGGCAGAGTA -> GTCTCATGGGGCAGAGTAA
AAACCACACAGTGGGAACC -> AACCACACAGTGGGAACCT
ACAGTGGATCTGAATATCT -> CAGTGGATCTGAATATCTA
GCTGGCTACTACTGCCGAT -> CTGGCTACTACTGCCGATT
CCCCGGAGTTGCAGGTTCT -> CCCGGAGTTGCAGGTTCTC
GTGGTGCGGCTGGCTACTA -> TGGTGCGGCTGGCTACTAC
CATGGGGCAGAGTAAGTTT -> ATGGGGCAGAGTAAGTTTT
TTCACTAATGTTTCGCGGT -> TCACTAATGTTTCGCGGTC
GAAAAATAATCGGATTTGA -> AAAAATAATCGGATTTGAA
CCGACCAGCCAGACACGTA -> CGACCAGCCAGACACGTAT
GCCTCGTCTGTTTGTGGTG -> CCTCGTCTGTTTGTGGTGC
ACAGTTGGCTTAACGTAAT -> CAGTTGGCTTAACGTAATG
CGGACGAGCACAAGTTACA -> GGACGAGCACAAGTTACAA
GTACTTATCGTCCGATTGG -> TACTTATCGTCCGATTGGC
GCTTGTGATGAGACAGGCG -> CTTGTGATGAGACAGGCGA
ATATCTAAATCGTGTTACC -> TATCTAAATCGTGTTACCA
AACAGAGGCGTAGCCGACC -> ACAGAGGCGTAGCCGACCA
CCAGTATTGGTTATGAATA -> CAGTATTGGTTATGAATAA
GTAGAATACGGTTAGCATA -> TAGAATACGGTTAGCATAA
GGACGTACTGGGTTCGTAC -> GACGTACTGGGTTCGTACA
TCAACGCGGTCCGGACACC -> CAACGCGGTCCGGACACCT
AATATCTAAATCGTGTTAC -> ATATCTAAATCGTGTTACC
AGTATAAACGGGCCGGGAC -> GTATAAACGGGCCGGGACT
ATGAGACAGGCGATTTCTC -> TGAGACAGGCGATTTCTCA
AGAAGTGAGCGCTCGTTGT -> GAAGTGAGCGCTCGTTGTC
ACCCGGTATGGGAAGCCAA -> CCCGGTATGGGAAGCCAAA
GTTCGTACAGTTGGCTTAA -> TTCGTACAGTTGGCTTAAC
CGCACACACCGTGTGCCAC -> GCACACACCGTGTGCCACG
CGTAGCACGATGGTAACCT -> GTAGCACGATGGTAACCTC
CGGAGGACCGTATCGGCTA -> GGAGGACCGTATCGGCTAG
CCTCCACCATTGGCGATGC -> CTCCACCATTGGCGATGCT
GATACGGTAGCCAAGTTCC -> ATACGGTAGCCAAGTTCCG
GTCGCGGTATTGCCGTGGA -> TCGCGGTATTGCCGTGGAG
ACAATCGGGCAACACTAGT -> CAATCGGGCAACACTAGTT
TACCGCCTCGAGTAGATAT -> ACCGCCTCGAGTAGATATC
CACAAGTTACAATCGGGCA -> ACAAGTTACAATCGGGCAA
TAGGCTCTCGATTTGCGTT -> AGGCTCTCGATTTGCGTTC
CGACGGCTTGTGATGAGAC -> GACGGCTTGTGATGAGACA
CGGGTCGTCCTTTAATACT -> GGGTCGTCCTTTAATACTC
ACCAACCATCCGCAGAATT -> CCAACCATCCGCAGAATTC
CGTTTTCCACGAGTTATTG -> GTTTTCCACGAGTTATTGT
CGAGTCGCGGTATTGCCGT -> GAGTCGCGGTATTGCCGTG
GGACCAACCATCCGCAGAA -> GACCAACCATCCGCAGAAT
GATGCTCTTTGTCCCGACA -> ATGCTCTTTGTCCCGACAG
CTGGCTCATGCTTTGACTC -> TGGCTCATGCTTTGACTCA
CGGGACTTGGGAACGCTAG -> GGGACTTGGGAACGCTAGC
GGACCGTATCGGCTAGATT -> GACCGTATCGGCTAGATTA
AGACACTACAGTATAGAGT -> GACACTACAGTATAGAGTA
AAAACACCTCACTGGGGTC -> AAACACCTCACTGGGGTCT
CCAACGCCTTTCCGCGAGC -> CAACGCCTTTCCGCGAGCC
GAAGTGAGCGCTCGTTGTC -> AAGTGAGCGCTCGTTGTCA
TAACGTAATGGGACACGCA -> AACGTAATGGGACACGCAC
TGGCTACTACTGCCGATTT -> GGCTACTACTGCCGATTTC
CTGAATATCTAAATCGTGT -> TGAATATCTAAATCGTGTT
GGTCTTCCCGCTGTACGGG -> GTCTTCCCGCTGTACGGGA
GAGGCGTAGCCGACCAGCC -> AGGCGTAGCCGACCAGCCA
TTATTGTTCTAGTTTCACC -> TATTGTTCTAGTTTCACCT
CACGTGTGCTGCAACACTA -> ACGTGTGCTGCAACACTAT
AAGACATCGTATAGGTATA -> AGACATCGTATAGGTATAG
GTGAATGCACCCGTTGTTA -> TGAATGCACCCGTTGTTAT
GATTGCATTCAGGTACGTC -> ATTGCATTCAGGTACGTCA
GGTTCTCCCATCGGTTCAT -> GTTCTCCCATCGGTTCATC
TCCGGGCCACCAGATACGG -> CCGGGCCACCAGATACGGT
CTGGTCGACCGGCTACACT -> TGGTCGACCGGCTACACTC
CGAGTGCCCATCCCATGGC -> GAGTGCCCATCCCATGGCG
TTGTTATGTTTGGTCAGAC -> TGTTATGTTTGGTCAGACG
TCCCGTTTTCCACGAGTTA -> CCCGTTTTCCACGAGTTAT
CAGCAAAATCTCGAGTGCC -> AGCAAAATCTCGAGTGCCC
ATTCAGGTACGTCAGGGCT -> TTCAGGTACGTCAGGGCTA
TTTGGTCAGACGCCATCTA -> TTGGTCAGACGCCATCTAT
AACCTCTCTCCGACGGCTT -> ACCTCTCTCCGACGGCTTG
CCGCGACCCCAGTATTGGT -> CGCGACCCCAGTATTGGTT
TTTCCTAATGGGAGGCTGT -> TTCCTAATGGGAGGCTGTG
AGGCATAGAGTATATGCGA -> GGCATAGAGTATATGCGAC
CAATCGAGTACTACGTTTA -> AATCGAGTACTACGTTTAA
TTTGTCCCGACAGCTCCGC -> TTGTCCCGACAGCTCCGCT
GCTCGTTGTCAACAAAGTC -> CTCGTTGTCAACAAAGTCC
TTCTAGTTTCACCTCCTAT -> TCTAGTTTCACCTCCTATT
TAGCCGACCAGCCAGACAC -> AGCCGACCAGCCAGACACG
CGAGTGGGATGTGTGGTTT -> GAGTGGGATGTGTGGTTTA
TGGATCGTCCCAACCGTGC -> GGATCGTCCCAACCGTGCC
CGCTCGTTGTCAACAAAGT -> GCTCGTTGTCAACAAAGTC
TTGACCTCCCATACCGCCT -> TGACCTCCCATACCGCCTC
GGAGGACCGTATCGGCTAG -> GAGGACCGTATCGGCTAGA
AGGCTTCCTTAATTGTGTA -> GGCTTCCTTAATTGTGTAA
ATCGTAGGCTCATCATCTC -> TCGTAGGCTCATCATCTCG
CAGATACGGTAGCCAAGTT -> AGATACGGTAGCCAAGTTC
TAGCATAAGTGTAGGTGAG -> AGCATAAGTGTAGGTGAGG
ACGGGCCGGGACTTGGGAA -> CGGGCCGGGACTTGGGAAC
GAATAAATACTAGTATTAG -> AATAAATACTAGTATTAGC
GGCTGGACGGAACAGTTTC -> GCTGGACGGAACAGTTTCC
GAGTGCCCATCCCATGGCG -> AGTGCCCATCCCATGGCGA
ACGCGGTCCGGACACCTCC -> CGCGGTCCGGACACCTCCC, CGCGGTCCGGACACCTCCC
AACTCAGAGGCATAGAGTA -> ACTCAGAGGCATAGAGTAT
GTAACCTGGGGCCTCGTCT -> TAACCTGGGGCCTCGTCTG
GGCTAGATTACGACTGATA -> GCTAGATTACGACTGATAT
TTATCCTGCTTTACGCGGT -> TATCCTGCTTTACGCGGTC
AGCAAAATCTCGAGTGCCC -> GCAAAATCTCGAGTGCCCA
CCACGAGTTATTGTTCTAG -> CACGAGTTATTGTTCTAGT
TTGGGAACGCTAGCCCTAA -> TGGGAACGCTAGCCCTAAG
TTAATTGTGTAACCCGTGA -> TAATTGTGTAACCCGTGAC
GCTCATGCTTTGACTCATC -> CTCATGCTTTGACTCATCT
CTAATAAGAATTTCAGAAA -> TAATAAGAATTTCAGAAAA
GTGATGAGACAGGCGATTT -> TGATGAGACAGGCGATTTC
AGGTGAGGACATTCTTTGG -> GGTGAGGACATTCTTTGGT
TCTTTGTCCCGACAGCTCC -> CTTTGTCCCGACAGCTCCG
TGGGTTCGTACAGTTGGCT -> GGGTTCGTACAGTTGGCTT
ATCGTCCGATTGGCTGGAC -> TCGTCCGATTGGCTGGACG
AACGGACGAGCACAAGTTA -> ACGGACGAGCACAAGTTAC
AAGTAAGCTGGTAGAATAC -> AGTAAGCTGGTAGAATACG
TAATCGGATTTGAACTCCT -> AATCGGATTTGAACTCCTA
CAACCATCCCGGCCATAAT -> AACCATCCCGGCCATAATG
GAGGACATTCTTTGGTGGG -> AGGACATTCTTTGGTGGGA
CTCGCCCAAATTTGGGCAA -> TCGCCCAAATTTGGGCAAT
TATAGGACTCAGTGTTTTC -> ATAGGACTCAGTGTTTTCT
GGTTCATCCTTAACCCAAA -> GTTCATCCTTAACCCAAAG
GGAAGCCAAACTAAGTGTA -> GAAGCCAAACTAAGTGTAT
GAGTGGGATGTGTGGTTTA -> AGTGGGATGTGTGGTTTAG
TGCAGGTTCTCCCATCGGT -> GCAGGTTCTCCCATCGGTT
CTCGATATGTTGAGCGCCA -> TCGATATGTTGAGCGCCAG
ATTCTTAAGTAAGCTGGTA -> TTCTTAAGTAAGCTGGTAG
CCCGGCCATAATGTACTTA -> CCGGCCATAATGTACTTAT
CAAAGGTATAGGACTCAGT -> AAAGGTATAGGACTCAGTG
ACCCAAAGGTATAGGACTC -> CCCAAAGGTATAGGACTCA
AAGTGTAGGTGAGGACATT -> AGTGTAGGTGAGGACATTC
GCAGAATTCTTAAGTAAGC -> CAGAATTCTTAAGTAAGCT
CGGGTTCGCTGAGGGACCG -> GGGTTCGCTGAGGGACCGC
ATATTAGATGCTTAATAGG -> TATTAGATGCTTAATAGGC
ATCGAGCTTATCGCGAGTC -> TCGAGCTTATCGCGAGTCG
ATGTTTCGCGGTCCGGACA -> TGTTTCGCGGTCCGGACAC
TGCAACTCAGAGGCATAGA -> GCAACTCAGAGGCATAGAG
TCCTTTAATACTCTCTTCC -> CCTTTAATACTCTCTTCCG
CCCAGGTAACCTGGGGCCT -> CCAGGTAACCTGGGGCCTC
AGTTCCGATTCCAAAGTCA -> GTTCCGATTCCAAAGTCAT
GACGGCTTGTGATGAGACA -> ACGGCTTGTGATGAGACAG
TTAATTTGACCTCCCATAC -> TAATTTGACCTCCCATACC
GAGTCGCGGTATTGCCGTG -> AGTCGCGGTATTGCCGTGG
GCAAAATCTCGAGTGCCCA -> CAAAATCTCGAGTGCCCAT
AGCCAAACTAAGTGTATAA -> GCCAAACTAAGTGTATAAG
GCACGATGGTAACCTCTCT -> CACGATGGTAACCTCTCTC
GGTAACCTGGGGCCTCGTC -> GTAACCTGGGGCCTCGTCT
TGGACTAATAAGAATTTCA -> GGACTAATAAGAATTTCAG
TCGCCCTCGCCCAAATTTG -> CGCCCTCGCCCAAATTTGG
TCTCACCCTACTTACCTTG -> CTCACCCTACTTACCTTGA
GCCGACTTCCAGCAAAATC -> CCGACTTCCAGCAAAATCT
CCCTCGATTGCATTCAGGT -> CCTCGATTGCATTCAGGTA
CAGAAAAACACCTCACTGG -> AGAAAAACACCTCACTGGG
AATCTCGAGTGCCCATCCC -> ATCTCGAGTGCCCATCCCA
CTTTGTCCCGACAGCTCCG -> TTTGTCCCGACAGCTCCGC
TCATCATCTCGAGTGGGAT -> CATCATCTCGAGTGGGATG
CTTGTTCGAAGTATAAACG -> TTGTTCGAAGTATAAACGG
GGCGGTTGCCCTCGATTGC -> GCGGTTGCCCTCGATTGCA
GTGGATCTGAATATCTAAA -> TGGATCTGAATATCTAAAT
CAGAGGCATAGAGTATATG -> AGAGGCATAGAGTATATGC
CCTCTAGGATTTTGCGTGT -> CTCTAGGATTTTGCGTGTT
TTCCTCCACAGTGGATCTG -> TCCTCCACAGTGGATCTGA
CTTAATTTGACCTCCCATA -> TTAATTTGACCTCCCATAC
TACCACCCGGTATGGGAAG -> ACCACCCGGTATGGGAAGC
ATCGTGTTACCACCCGGTA -> TCGTGTTACCACCCGGTAT
ATGCACCCGTTGTTATGTT -> TGCACCCGTTGTTATGTTT
CCCATCCCATGGCGACAAT -> CCATCCCATGGCGACAATC
GTCCAATCGGAGGACCGTA -> TCCAATCGGAGGACCGTAT
TGCTTCTCCGAAAAATAAT -> GCTTCTCCGAAAAATAATC
CACGTAATATACAACAGGG -> ACGTAATATACAACAGGGT
GATCGTCCCAACCGTGCCG -> ATCGTCCCAACCGTGCCGG
TCTCGAGTGGGATGTGTGG -> CTCGAGTGGGATGTGTGGT
AGTTCTGGCTCATGCTTTG -> GTTCTGGCTCATGCTTTGA
TCTAAATCGTGTTACCACC -> CTAAATCGTGTTACCACCC
CCTCCTATTTCGAAATTCA -> CTCCTATTTCGAAATTCAA
GTGTGCTGCAACACTATCG -> TGTGCTGCAACACTATCGT
ATTTCAGAAAAACACCTCA -> TTTCAGAAAAACACCTCAC
TGCAATCGAGTACTACGTT -> GCAATCGAGTACTACGTTT
CACCGTGTGCCACGTGACC -> ACCGTGTGCCACGTGACCC
TATAGGGACTCGCCTGGTC -> ATAGGGACTCGCCTGGTCG
GATATCGAGCTTATCGCGA -> ATATCGAGCTTATCGCGAG
GGATGTGTGGTTTAGACAC -> GATGTGTGGTTTAGACACT
TCGATTGCATTCAGGTACG -> CGATTGCATTCAGGTACGT
GTTTTCCCGATGGACGGAG -> TTTTCCCGATGGACGGAGG
GACACCTCCCTATTATTTA -> ACACCTCCCTATTATTTAC
TTGTGGTGCGGCTGGCTAC -> TGTGGTGCGGCTGGCTACT
CGCCTGGTCGACCGGCTAC -> GCCTGGTCGACCGGCTACA
GGACTTGGGAACGCTAGCC -> GACTTGGGAACGCTAGCCC
CTATTCACTAATGTTTCGC -> TATTCACTAATGTTTCGCG
ATTTTTTGGCATGTTAAGA -> TTTTTTGGCATGTTAAGAA
CTTCCTCCACAGTGGATCT -> TTCCTCCACAGTGGATCTG
CTCCTATTTCGAAATTCAA -> TCCTATTTCGAAATTCAAC
CCTATTGTACGTGAAGGCG -> CTATTGTACGTGAAGGCGC
AGACATCGTATAGGTATAG -> GACATCGTATAGGTATAGG
TGGTCGACCGGCTACACTC -> GGTCGACCGGCTACACTCG
CCCAAATTTGGGCAATGCG -> CCAAATTTGGGCAATGCGG
TGATTACGCACGTAGTTGA -> GATTACGCACGTAGTTGAT
GCGTCCGGGCCACCAGATA -> CGTCCGGGCCACCAGATAC
CTACGGTGGATCGTCCCAA -> TACGGTGGATCGTCCCAAC
TTTCCACGAGTTATTGTTC -> TTCCACGAGTTATTGTTCT
TGGGAACGCTAGCCCTAAG -> GGGAACGCTAGCCCTAAGT
ATTTCGAAATTCAACGCGG -> TTTCGAAATTCAACGCGGT
CCGGACACCTCCCCGGAGT -> CGGACACCTCCCCGGAGTT
AGGGACCGCATAAACCACA -> GGGACCGCATAAACCACAC
GTGTTTTCTTCCCTCTAGG -> TGTTTTCTTCCCTCTAGGA
CAAGTTCCGATTCCAAAGT -> AAGTTCCGATTCCAAAGTC
GAAGGCGCGGTCCGGACAC -> AAGGCGCGGTCCGGACACC
CTCGAGTGGGATGTGTGGT -> TCGAGTGGGATGTGTGGTT
AACCTTCCTCCACAGTGGA -> ACCTTCCTCCACAGTGGAT
GACACCTCCCTAAATATTA -> ACACCTCCCTAAATATTAG
TCAGAGGCATAGAGTATAT -> CAGAGGCATAGAGTATATG
AGTATAGAGTATGGCGGTT -> GTATAGAGTATGGCGGTTG
TACTGGGTTCGTACAGTTG -> ACTGGGTTCGTACAGTTGG
ACGTACTGGGTTCGTACAG -> CGTACTGGGTTCGTACAGT
AGGTTCTCCCATCGGTTCA -> GGTTCTCCCATCGGTTCAT
TTTACGAGGTTGTCCTGAA -> TTACGAGGTTGTCCTGAAA
GACCAACCATCCGCAGAAT -> ACCAACCATCCGCAGAATT
AATAAATACTAGTATTAGC -> ATAAATACTAGTATTAGCC
TGGGAGGCTGTGGCGTGAC -> GGGAGGCTGTGGCGTGACT
GCGTAGCCGACCAGCCAGA -> CGTAGCCGACCAGCCAGAC
TCCAGCAAAATCTCGAGTG -> CCAGCAAAATCTCGAGTGC
GGCTTCCTTAATTGTGTAA -> GCTTCCTTAATTGTGTAAC
CCATGACAGCCCCCGAGCA -> CATGACAGCCCCCGAGCAA
TGCGACTTAATTTGACCTC -> GCGACTTAATTTGACCTCC
AATGTTTCGCGGTCCGGAC -> ATGTTTCGCGGTCCGGACA
GACGGTCGCCCTCGCCCAA -> ACGGTCGCCCTCGCCCAAA
CAGTATAGAGTATGGCGGT -> AGTATAGAGTATGGCGGTT
AATAATCGGATTTGAACTC -> ATAATCGGATTTGAACTCC
TCCGCTAGCGGAACAGATG -> CCGCTAGCGGAACAGATGT
TGATATTTGCTATTTGTTC -> GATATTTGCTATTTGTTCG
CTCATCATCTCGAGTGGGA -> TCATCATCTCGAGTGGGAT
CCAACCATCCGCAGAATTC -> CAACCATCCGCAGAATTCT
CGCGAGTCGCGGTATTGCC -> GCGAGTCGCGGTATTGCCG
AACCCGTGACGGTCGCCCT -> ACCCGTGACGGTCGCCCTC
CACACACCGTGTGCCACGT -> ACACACCGTGTGCCACGTG
GATAGCAAGCGTAGCACGA -> ATAGCAAGCGTAGCACGAT
ATAGATCTCGTCAGACCTC -> TAGATCTCGTCAGACCTCC
AGCCGAGCCTCCGCTAGTT -> GCCGAGCCTCCGCTAGTTT
GCTAGTTTCACCTCCTATT -> CTAGTTTCACCTCCTATTG
CGTAGGCTCATCATCTCGA -> GTAGGCTCATCATCTCGAG
AAATTTGGGCAATGCGGGT -> AATTTGGGCAATGCGGGTT
CTCTTCCGAGCTTAAGGGA -> TCTTCCGAGCTTAAGGGAT
GCTTCCTTAATTGTGTAAC -> CTTCCTTAATTGTGTAACC
GAAATTCAACGCGGTCCGG -> AAATTCAACGCGGTCCGGA
AGGACTCAGTGTTTTCTTC -> GGACTCAGTGTTTTCTTCC
CAGACTTTTACATAGATCT -> AGACTTTTACATAGATCTC
TAGCAAGCGTAGCACGATG -> AGCAAGCGTAGCACGATGG
CATGTTAAGAAACCTTCCA -> ATGTTAAGAAACCTTCCAC
GGCGACAATCACTGATTAC -> GCGACAATCACTGATTACG
CGGAACAGATGTAAACGGA -> GGAACAGATGTAAACGGAC
TGGCGATGCTCTTTGTCCC -> GGCGATGCTCTTTGTCCCG
ACGTTAGGACCAACCATCC -> CGTTAGGACCAACCATCCG
GGCAACACTAGTTTCACCT -> GCAACACTAGTTTCACCTC
TTTGTGGTGCGGCTGGCTA -> TTGTGGTGCGGCTGGCTAC
TGCCGATTTCCTGTGCATA -> GCCGATTTCCTGTGCATAG
GGAGGCTTCCTTAATTGTG -> GAGGCTTCCTTAATTGTGT
GGGAAGGTTATGTACTAGG -> GGAAGGTTATGTACTAGGT
CAGGTAACCTGGGGCCTCG -> AGGTAACCTGGGGCCTCGT
AAGAATTTCAGAAAAACAC -> AGAATTTCAGAAAAACACC
TCCACAGTGGATCTGAATA -> CCACAGTGGATCTGAATAT
CAACGCGGTCCGGACACCT -> AACGCGGTCCGGACACCTC
TTTCCGTAAGCCGAGCCTC -> TTCCGTAAGCCGAGCCTCC
CGTAAGCCGAGCCTCCGCT -> GTAAGCCGAGCCTCCGCTA
TCGAGTACTACGTTTAACA -> CGAGTACTACGTTTAACAA
ACCGCCTCGAGTAGATATC -> CCGCCTCGAGTAGATATCG
TTCATCCTTAACCCAAAGG -> TCATCCTTAACCCAAAGGT
TTACGCACGTAGTTGATGA -> TACGCACGTAGTTGATGAG
GTTAGCATAAGTGTAGGTG -> TTAGCATAAGTGTAGGTGA
GGTTATGTACTAGGTTCGC -> GTTATGTACTAGGTTCGCC
CCTTGTTCGAAGTATAAAC -> CTTGTTCGAAGTATAAACG
CCTATTATCCTGCTTTACG -> CTATTATCCTGCTTTACGC
AGACAGGCGATTTCTCACC -> GACAGGCGATTTCTCACCC
CAATGCGGGTTCGCTGAGG -> AATGCGGGTTCGCTGAGGG
GCATAAGTGTAGGTGAGGA -> CATAAGTGTAGGTGAGGAC
CGTACAGTTGGCTTAACGT -> GTACAGTTGGCTTAACGTA
AATAAGAATTTCAGAAAAA -> ATAAGAATTTCAGAAAAAC
AGTTGGCTTAACGTAATGG -> GTTGGCTTAACGTAATGGG
ACTTGGGAACGCTAGCCCT -> CTTGGGAACGCTAGCCCTA
ATGGCGACAATCACTGATT -> TGGCGACAATCACTGATTA
CCGGACACCTCCCTATTAT -> CGGACACCTCCCTATTATT
TTCCCGATGGACGGAGGAG -> TCCCGATGGACGGAGGAGG
CGACCCCAGTATTGGTTAT -> GACCCCAGTATTGGTTATG
ACCTCCTATTATCCTGCTT -> CCTCCTATTATCCTGCTTT
CGTTCGGGGCAGTCTCATG -> GTTCGGGGCAGTCTCATGG
CGGCTAGATTACGACTGAT -> GGCTAGATTACGACTGATA
TTGAACTCCTAGTTTCACC -> TGAACTCCTAGTTTCACCT
GGATAGCAAGCGTAGCACG -> GATAGCAAGCGTAGCACGA
AATTTCAGAAAAACACCTC -> ATTTCAGAAAAACACCTCA
TCTAGGATTTTGCGTGTTC -> CTAGGATTTTGCGTGTTCA
AGTTTCACCTCCTATTATC -> GTTTCACCTCCTATTATCC
AGCCTTGTTCGAAGTATAA -> GCCTTGTTCGAAGTATAAA
ATTGGCTGGACGGAACAGT -> TTGGCTGGACGGAACAGTT
GCTGGACGGAACAGTTTCC -> CTGGACGGAACAGTTTCCA
TCGTAGGCTCATCATCTCG -> CGTAGGCTCATCATCTCGA
GAACACGTGTGCTGCAACA -> AACACGTGTGCTGCAACAC
CAGACGCCATCTATCGTAG -> AGACGCCATCTATCGTAGG
CCGAGCCTCCGCTAGTTTC -> CGAGCCTCCGCTAGTTTCA
TAACAATCCCGTTTTCCAC -> AACAATCCCGTTTTCCACG
GGCCACCAGATACGGTAGC -> GCCACCAGATACGGTAGCC
CCTGAAAACGCCGTGTGCT -> CTGAAAACGCCGTGTGCTT
AGGTTCGCCAAAGACGAGG -> GGTTCGCCAAAGACGAGGC
ACGCACGTAGTTGATGAGC -> CGCACGTAGTTGATGAGCG
GAGCTTATCGCGAGTCGCG -> AGCTTATCGCGAGTCGCGG
TGGTAGAATACGGTTAGCA -> GGTAGAATACGGTTAGCAT
CCTTAATTGTGTAACCCGT -> CTTAATTGTGTAACCCGTG
GTTTCACCTCCTATTCACT -> TTTCACCTCCTATTCACTA
TCGCGAGTCGCGGTATTGC -> CGCGAGTCGCGGTATTGCC
TTACGACTGATATTTGCTA -> TACGACTGATATTTGCTAT
ACTCGATATGTTGAGCGCC -> CTCGATATGTTGAGCGCCA
ATCGTATAGGTATAGGGAC -> TCGTATAGGTATAGGGACT
GTATGGCGGTTGCCCTCGA -> TATGGCGGTTGCCCTCGAT
TCCGAAAAATAATCGGATT -> CCGAAAAATAATCGGATTT
TGCCGTGGAGCGGAGATGA -> GCCGTGGAGCGGAGATGAC
CCCCCGAGCAAGAGAAGTG -> CCCCGAGCAAGAGAAGTGA
CTAAGACATCGTATAGGTA -> TAAGACATCGTATAGGTAT
ATGCTTAATAGGCGCACGC -> TGCTTAATAGGCGCACGCT
TCCTATTGTACGTGAAGGC -> CCTATTGTACGTGAAGGCG
AGGTATAGGGACTCGCCTG -> GGTATAGGGACTCGCCTGG
CTCCTAGTTTCACCTCCTA -> TCCTAGTTTCACCTCCTAT
AAGTTTTCCCGATGGACGG -> AGTTTTCCCGATGGACGGA
AAGTATAAACGGGCCGGGA -> AGTATAAACGGGCCGGGAC
CCCGTGACGGTCGCCCTCG -> CCGTGACGGTCGCCCTCGC
TCCTGTGCATAGGCTCTCG -> CCTGTGCATAGGCTCTCGA
ACTGCCGATTTCCTGTGCA -> CTGCCGATTTCCTGTGCAT
TGCTCTTTGTCCCGACAGC -> GCTCTTTGTCCCGACAGCT
ACCTCCTATTTCGAAATTC -> CCTCCTATTTCGAAATTCA
CTTTGACTCATCTAGGCGT -> TTTGACTCATCTAGGCGTC
ATTGCATTCAGGTACGTCA -> TTGCATTCAGGTACGTCAG
TTTGCGTTCGGGGCAGTCT -> TTGCGTTCGGGGCAGTCTC
AACCGTGCCGGGTCGTCCT -> ACCGTGCCGGGTCGTCCTT
AGATACGGTAGCCAAGTTC -> GATACGGTAGCCAAGTTCC
ATTCACTAATGTTTCGCGG -> TTCACTAATGTTTCGCGGT
CCGGAGTTGCAGGTTCTCC -> CGGAGTTGCAGGTTCTCCC
ATGCTCTTTGTCCCGACAG -> TGCTCTTTGTCCCGACAGC
AATCACTGATTACGCACGT -> ATCACTGATTACGCACGTA
TTAAGGGATAGCAAGCGTA -> TAAGGGATAGCAAGCGTAG
CTAGTTTCACCTCCTATTG -> TAGTTTCACCTCCTATTGT
CTGGGGTCTTTCCTAATGG -> TGGGGTCTTTCCTAATGGG
GTATTGCCGTGGAGCGGAG -> TATTGCCGTGGAGCGGAGA
TATTGCCGTGGAGCGGAGA -> ATTGCCGTGGAGCGGAGAT
GGTGAGGACATTCTTTGGT -> GTGAGGACATTCTTTGGTG
GCCGATTTCCTGTGCATAG -> CCGATTTCCTGTGCATAGG
TATGTTTGGTCAGACGCCA -> ATGTTTGGTCAGACGCCAT
ACACACCGTGTGCCACGTG -> CACACCGTGTGCCACGTGA
CCATGGCGACAATCACTGA -> CATGGCGACAATCACTGAT
TAGTTTCACCTCCTATTAT -> AGTTTCACCTCCTATTATC
TAAGTAAGCTGGTAGAATA -> AAGTAAGCTGGTAGAATAC
TCACCTCCTATTTCGAAAT -> CACCTCCTATTTCGAAATT
TTTGGTGGGAAGGTTATGT -> TTGGTGGGAAGGTTATGTA
ATGGGAGGCTGTGGCGTGA -> TGGGAGGCTGTGGCGTGAC
GGCTGTGGCGTGACTACGG -> GCTGTGGCGTGACTACGGT
ACTAATGTTTCGCGGTCCG -> CTAATGTTTCGCGGTCCGG
TAGACACTACAGTATAGAG -> AGACACTACAGTATAGAGT
TAGTTTCACCTCCTATTCA -> AGTTTCACCTCCTATTCAC
GGAGATGACGTTAGGACCA -> GAGATGACGTTAGGACCAA
CCGTGTGCTTCTCCGAAAA -> CGTGTGCTTCTCCGAAAAA
ATCCTTAACCCAAAGGTAT -> TCCTTAACCCAAAGGTATA
CGTGTTCAACCATCCCGGC -> GTGTTCAACCATCCCGGCC
GACTTAATTTGACCTCCCA -> ACTTAATTTGACCTCCCAT
TGACCTCCCATACCGCCTC -> GACCTCCCATACCGCCTCG
ACTAGTATTAGCCGTCTTG -> CTAGTATTAGCCGTCTTGG
TCGCCGACTTCCAGCAAAA -> CGCCGACTTCCAGCAAAAT
TTTCCACGTAATATACAAC -> TTCCACGTAATATACAACA
GCTTAACGTAATGGGACAC -> CTTAACGTAATGGGACACG
GTAATATACAACAGGGTCT -> TAATATACAACAGGGTCTT
TACTTATCGTCCGATTGGC -> ACTTATCGTCCGATTGGCT
AGGACCGTATCGGCTAGAT -> GGACCGTATCGGCTAGATT
CGGAGATGACGTTAGGACC -> GGAGATGACGTTAGGACCA
GATATGTTGAGCGCCAGGT -> ATATGTTGAGCGCCAGGTC
TCAACCATCCCGGCCATAA -> CAACCATCCCGGCCATAAT
CTCGTCTGTTTGTGGTGCG -> TCGTCTGTTTGTGGTGCGG
GGGCCTGCGTCCAATCGGA -> GGCCTGCGTCCAATCGGAG
GAAGTATAAACGGGCCGGG -> AAGTATAAACGGGCCGGGA
CCTCCTATTGTACGTGAAG -> CTCCTATTGTACGTGAAGG
CAGTCTCATGGGGCAGAGT -> AGTCTCATGGGGCAGAGTA
CATAAGTGTAGGTGAGGAC -> ATAAGTGTAGGTGAGGACA
GTAGATATCGAGCTTATCG -> TAGATATCGAGCTTATCGC
TATTTCGAAATTCAACGCG -> ATTTCGAAATTCAACGCGG
ATGGTTGCAATCGAGTACT -> TGGTTGCAATCGAGTACTA
TCACTGGGGTCTTTCCTAA -> CACTGGGGTCTTTCCTAAT
GCGTGTTCAACCATCCCGG -> CGTGTTCAACCATCCCGGC
GGGAACGCTAGCCCTAAGT -> GGAACGCTAGCCCTAAGTT
AGTCGCGGTATTGCCGTGG -> GTCGCGGTATTGCCGTGGA
GTAGCCAAGTTCCGATTCC -> TAGCCAAGTTCCGATTCCA
GTATTGGTTATGAATAAAT -> TATTGGTTATGAATAAATA
TGAAAACGCCGTGTGCTTC -> GAAAACGCCGTGTGCTTCT
AGCTTAAGGGATAGCAAGC -> GCTTAAGGGATAGCAAGCG
TGCCCTCGATTGCATTCAG -> GCCCTCGATTGCATTCAGG
GCCGGGACTTGGGAACGCT -> CCGGGACTTGGGAACGCTA
GGGCAGTCTCATGGGGCAG -> GGCAGTCTCATGGGGCAGA
GGCTAAGACATCGTATAGG -> GCTAAGACATCGTATAGGT
CACGTGACCCAGGTAACCT -> ACGTGACCCAGGTAACCTG
GTCCGGACACCTCCCCTCA -> TCCGGACACCTCCCCTCAT
CCCCAGTATTGGTTATGAA -> CCCAGTATTGGTTATGAAT
TCCAACGCCTTTCCGCGAG -> CCAACGCCTTTCCGCGAGC
GATCTGAATATCTAAATCG -> ATCTGAATATCTAAATCGT
AGCCGACCAGCCAGACACG -> GCCGACCAGCCAGACACGT
CCGGCCATAATGTACTTAT -> CGGCCATAATGTACTTATC
GCCTCGAGTAGATATCGAG -> CCTCGAGTAGATATCGAGC
ATCGGATTTGAACTCCTAG -> TCGGATTTGAACTCCTAGT
TTGCATTCAGGTACGTCAG -> TGCATTCAGGTACGTCAGG
CGCCAAAGACGAGGCACTG -> GCCAAAGACGAGGCACTGA
TGAGGGACCGCATAAACCA -> GAGGGACCGCATAAACCAC
CTGGGGCCTCGTCTGTTTG -> TGGGGCCTCGTCTGTTTGT
TCATGGGGCAGAGTAAGTT -> CATGGGGCAGAGTAAGTTT
GGAGGTGAATGCACCCGTT -> GAGGTGAATGCACCCGTTG
GGGTTCGCTGAGGGACCGC -> GGTTCGCTGAGGGACCGCA
CCGAAAAATAATCGGATTT -> CGAAAAATAATCGGATTTG
ACCTTGAGACCTGTTGAAC -> CCTTGAGACCTGTTGAACA
CGATTTCTCACCCTACTTA -> GATTTCTCACCCTACTTAC
AGTTATTGTTCTAGTTTCA -> GTTATTGTTCTAGTTTCAC
GATTTCCTGTGCATAGGCT -> ATTTCCTGTGCATAGGCTC
CATACCGCCTCGAGTAGAT -> ATACCGCCTCGAGTAGATA
TGATGAGCGTCCGGGCCAC -> GATGAGCGTCCGGGCCACC
TAGCACGATGGTAACCTCT -> AGCACGATGGTAACCTCTC
CACCTCCTATTTCGAAATT -> ACCTCCTATTTCGAAATTC
ATTTGAACTCCTAGTTTCA -> TTTGAACTCCTAGTTTCAC
GACCCCAGTATTGGTTATG -> ACCCCAGTATTGGTTATGA
CCGACTTCCAGCAAAATCT -> CGACTTCCAGCAAAATCTC
GCGGCTGGCTACTACTGCC -> CGGCTGGCTACTACTGCCG
CCGTATCGGCTAGATTACG -> CGTATCGGCTAGATTACGA
TTTACGCGGTCCGGACACC -> TTACGCGGTCCGGACACCT
GGCTTAACGTAATGGGACA -> GCTTAACGTAATGGGACAC
CGATTGCATTCAGGTACGT -> GATTGCATTCAGGTACGTC
GCCGTCTTGGAAGCCTACA -> CCGTCTTGGAAGCCTACAC
GGGACACGCACACACCGTG -> GGACACGCACACACCGTGT
TCTCCGAAAAATAATCGGA -> CTCCGAAAAATAATCGGAT
CGATGCTCTTTGTCCCGAC -> GATGCTCTTTGTCCCGACA
TTCTCCGAAAAATAATCGG -> TCTCCGAAAAATAATCGGA
ATAAGTGTAGGTGAGGACA -> TAAGTGTAGGTGAGGACAT
CATGACAGCCCCCGAGCAA -> ATGACAGCCCCCGAGCAAG
TCGGGGCAGTCTCATGGGG -> CGGGGCAGTCTCATGGGGC
ACGCTAGCCCTAAGTTCTG -> CGCTAGCCCTAAGTTCTGG
GGGGCCTCGTCTGTTTGTG -> GGGCCTCGTCTGTTTGTGG
CCAGACACGTATGGTTGCA -> CAGACACGTATGGTTGCAA
TGGTTTAGACACTACAGTA -> GGTTTAGACACTACAGTAT
CGGCTTGTGATGAGACAGG -> GGCTTGTGATGAGACAGGC
GCAACACTATCGTGCAAAC -> CAACACTATCGTGCAAACA
TCGAGCTTATCGCGAGTCG -> CGAGCTTATCGCGAGTCGC
CATCGTATAGGTATAGGGA -> ATCGTATAGGTATAGGGAC
GCATGTTAAGAAACCTTCC -> CATGTTAAGAAACCTTCCA
CCAAGTTCCGATTCCAAAG -> CAAGTTCCGATTCCAAAGT
TGTTCGAAGTATAAACGGG -> GTTCGAAGTATAAACGGGC
CCCGGAGTTGCAGGTTCTC -> CCGGAGTTGCAGGTTCTCC
GACACGCACACACCGTGTG -> ACACGCACACACCGTGTGC
TTACATAGATCTCGTCAGA -> TACATAGATCTCGTCAGAC
CCGCTAGCGGAACAGATGT -> CGCTAGCGGAACAGATGTA
TAGGATTTTGCGTGTTCAA -> AGGATTTTGCGTGTTCAAC
TGCGTGTTCAACCATCCCG -> GCGTGTTCAACCATCCCGG
TCACCTCCTATTCACTAAT -> CACCTCCTATTCACTAATG
CGTATAGGTATAGGGACTC -> GTATAGGTATAGGGACTCG
TGTTATGTTTGGTCAGACG -> GTTATGTTTGGTCAGACGC
CGTAGTTGATGAGCGTCCG -> GTAGTTGATGAGCGTCCGG
GTGTTCAACCATCCCGGCC -> TGTTCAACCATCCCGGCCA
GATGTAAACGGACGAGCAC -> ATGTAAACGGACGAGCACA
CCACCCGGTATGGGAAGCC -> CACCCGGTATGGGAAGCCA
CCGGCTACACTCGATATGT -> CGGCTACACTCGATATGTT
CTTATCGTCCGATTGGCTG -> TTATCGTCCGATTGGCTGG
GTTCGAAGTATAAACGGGC -> TTCGAAGTATAAACGGGCC
ACACCTCCCCTCATAATCG -> CACCTCCCCTCATAATCGG
CCTAAGTTCTGGCTCATGC -> CTAAGTTCTGGCTCATGCT
AATCGGATTTGAACTCCTA -> ATCGGATTTGAACTCCTAG
GGACACCTCCCCTCATAAT -> GACACCTCCCCTCATAATC
GTTATGAATAAATACTAGT -> TTATGAATAAATACTAGTA
TGTACTAGGTTCGCCAAAG -> GTACTAGGTTCGCCAAAGA
ATTGGACTAATAAGAATTT -> TTGGACTAATAAGAATTTC
CAACAGGGTCTTCCCGCTG -> AACAGGGTCTTCCCGCTGT
TTCCGATTCCAAAGTCATG -> TCCGATTCCAAAGTCATGC
GAAACCTTCCACAGACTTT -> AAACCTTCCACAGACTTTT
CACGTAGTTGATGAGCGTC -> ACGTAGTTGATGAGCGTCC
GTTCAACCATCCCGGCCAT -> TTCAACCATCCCGGCCATA
TCCACGAGTTATTGTTCTA -> CCACGAGTTATTGTTCTAG
GGCGTCTATTTTTTGGCAT -> GCGTCTATTTTTTGGCATG
ATGTGTGGTTTAGACACTA -> TGTGTGGTTTAGACACTAC
ACCCGCGACCCCAGTATTG -> CCCGCGACCCCAGTATTGG
ATTACGCACGTAGTTGATG -> TTACGCACGTAGTTGATGA
AAGCTGGTAGAATACGGTT -> AGCTGGTAGAATACGGTTA
CCGTGTGCCACGTGACCCA -> CGTGTGCCACGTGACCCAG
TGCCCATCCCATGGCGACA -> GCCCATCCCATGGCGACAA
TGAGGACATTCTTTGGTGG -> GAGGACATTCTTTGGTGGG
AGCACAAGTTACAATCGGG -> GCACAAGTTACAATCGGGC
ATGCGGGTTCGCTGAGGGA -> TGCGGGTTCGCTGAGGGAC
GTCTGTTTGTGGTGCGGCT -> TCTGTTTGTGGTGCGGCTG
TGAATATCTAAATCGTGTT -> GAATATCTAAATCGTGTTA
CTATTTGTTCGTTACAAGA -> TATTTGTTCGTTACAAGAG
GCTCTCGATTTGCGTTCGG -> CTCTCGATTTGCGTTCGGG
TAACCCAAAGGTATAGGAC -> AACCCAAAGGTATAGGACT
CTAGTTTCACCTCCTATTC -> TAGTTTCACCTCCTATTCA
CCATCGGTTCATCCTTAAC -> CATCGGTTCATCCTTAACC
AAATAATCGGATTTGAACT -> AATAATCGGATTTGAACTC
ACTGGGGTCTTTCCTAATG -> CTGGGGTCTTTCCTAATGG
CCATTGGCGATGCTCTTTG -> CATTGGCGATGCTCTTTGT
CCTCGATTGCATTCAGGTA -> CTCGATTGCATTCAGGTAC
AGAATTTCAGAAAAACACC -> GAATTTCAGAAAAACACCT
ACTACGTTTAACAATCCCG -> CTACGTTTAACAATCCCGT
GGTTCGCTGAGGGACCGCA -> GTTCGCTGAGGGACCGCAT
AAGTGTATAAGTGGGCCTG -> AGTGTATAAGTGGGCCTGC
AAGTCATGCAACTCAGAGG -> AGTCATGCAACTCAGAGGC
AGCATAAGTGTAGGTGAGG -> GCATAAGTGTAGGTGAGGA
ATCCCGTTTTCCACGAGTT -> TCCCGTTTTCCACGAGTTA
TATGTTGAGCGCCAGGTCT -> ATGTTGAGCGCCAGGTCTC
CACCCTACTTACCTTGAGA -> ACCCTACTTACCTTGAGAC
TCGGGCAACACTAGTTTCA -> CGGGCAACACTAGTTTCAC
GTGGATCGTCCCAACCGTG -> TGGATCGTCCCAACCGTGC
TTGGCATGTTAAGAAACCT -> TGGCATGTTAAGAAACCTT
CCACCAGATACGGTAGCCA -> CACCAGATACGGTAGCCAA
CTCTCCGACGGCTTGTGAT -> TCTCCGACGGCTTGTGATG
CTGCCGATTTCCTGTGCAT -> TGCCGATTTCCTGTGCATA
TTCGCCAAAGACGAGGCAC -> TCGCCAAAGACGAGGCACT
GAACTCCTAGTTTCACCTC -> AACTCCTAGTTTCACCTCC
GAGACAGGCGATTTCTCAC -> AGACAGGCGATTTCTCACC
TCCTCCACAGTGGATCTGA -> CCTCCACAGTGGATCTGAA
CACCCGTTGTTATGTTTGG -> ACCCGTTGTTATGTTTGGT
GTTTCACCTCCTATTTCGA -> TTTCACCTCCTATTTCGAA
CATCCCATGGCGACAATCA -> ATCCCATGGCGACAATCAC
TAGGACCAACCATCCGCAG -> AGGACCAACCATCCGCAGA
GTTTTCCACGAGTTATTGT -> TTTTCCACGAGTTATTGTT
CCTCGCCCAAATTTGGGCA -> CTCGCCCAAATTTGGGCAA
GTTCGCCAAAGACGAGGCA -> TTCGCCAAAGACGAGGCAC
GCTTCTCCGAAAAATAATC -> CTTCTCCGAAAAATAATCG
TGAGCGCCAGGTCTCGCCG -> GAGCGCCAGGTCTCGCCGA
AGGGGACGTACTGGGTTCG -> GGGGACGTACTGGGTTCGT
CATCCGCAGAATTCTTAAG -> ATCCGCAGAATTCTTAAGT
CTTTAATACTCTCTTCCGA -> TTTAATACTCTCTTCCGAG
CTGTTTGTGGTGCGGCTGG -> TGTTTGTGGTGCGGCTGGC
CCCAGTATTGGTTATGAAT -> CCAGTATTGGTTATGAATA
ATCGTGCAAACAGAGGCGT -> TCGTGCAAACAGAGGCGTA
ATAGGCTCTCGATTTGCGT -> TAGGCTCTCGATTTGCGTT
CAAGAGTCGCGTTTCCGTA -> AAGAGTCGCGTTTCCGTAA
TATTTGCTATTTGTTCGTT -> ATTTGCTATTTGTTCGTTA
CCGCTGTACGGGAGGTGAA -> CGCTGTACGGGAGGTGAAT
TAGTTTCACCTCCTATTGT -> AGTTTCACCTCCTATTGTA
GCCGAGCCTCCGCTAGTTT -> CCGAGCCTCCGCTAGTTTC
GGAGGAGGCTTCCTTAATT -> GAGGAGGCTTCCTTAATTG
TACTACTGCCGATTTCCTG -> ACTACTGCCGATTTCCTGT
CAACGCCTTTCCGCGAGCC -> AACGCCTTTCCGCGAGCCT
GCCAAACTAAGTGTATAAG -> CCAAACTAAGTGTATAAGT
TCGTATAGGTATAGGGACT -> CGTATAGGTATAGGGACTC
TCCGCAGAATTCTTAAGTA -> CCGCAGAATTCTTAAGTAA
AACCTGGGGCCTCGTCTGT -> ACCTGGGGCCTCGTCTGTT
CCACGTAATATACAACAGG -> CACGTAATATACAACAGGG
GAGATGACGTTAGGACCAA -> AGATGACGTTAGGACCAAC
AACAAAGTCCAACGCCTTT -> ACAAAGTCCAACGCCTTTC
GTCTTCCCGCTGTACGGGA -> TCTTCCCGCTGTACGGGAG
CTTACCTTGAGACCTGTTG -> TTACCTTGAGACCTGTTGA
CTAAGTTCTGGCTCATGCT -> TAAGTTCTGGCTCATGCTT
TCCCTAAATATTAGATGCT -> CCCTAAATATTAGATGCTT
GTTGTCAACAAAGTCCAAC -> TTGTCAACAAAGTCCAACG
GTGCTTCTCCGAAAAATAA -> TGCTTCTCCGAAAAATAAT
GAAGCCAAACTAAGTGTAT -> AAGCCAAACTAAGTGTATA
CTTCTCCGAAAAATAATCG -> TTCTCCGAAAAATAATCGG
GCCGTGGAGCGGAGATGAC -> CCGTGGAGCGGAGATGACG
TTGTCCCGACAGCTCCGCT -> TGTCCCGACAGCTCCGCTA
ATAGGCGCACGCTCCCCTA -> TAGGCGCACGCTCCCCTAC
TTACGCGGTCCGGACACCT -> TACGCGGTCCGGACACCTC
GGTATAGGACTCAGTGTTT -> GTATAGGACTCAGTGTTTT
GTTGAGCGCCAGGTCTCGC -> TTGAGCGCCAGGTCTCGCC
TGGCTTAACGTAATGGGAC -> GGCTTAACGTAATGGGACA
CGACCGGCTACACTCGATA -> GACCGGCTACACTCGATAT
AGGCGTCTATTTTTTGGCA -> GGCGTCTATTTTTTGGCAT
ATATTTGCTATTTGTTCGT -> TATTTGCTATTTGTTCGTT
TGTTCGTTACAAGAGTCGC -> GTTCGTTACAAGAGTCGCG
AGTCCAACGCCTTTCCGCG -> GTCCAACGCCTTTCCGCGA
GACCTCCACCATTGGCGAT -> ACCTCCACCATTGGCGATG
CCGGACACCTCCCTAAATA -> CGGACACCTCCCTAAATAT
CTACAGTATAGAGTATGGC -> TACAGTATAGAGTATGGCG
TTTTTGGCATGTTAAGAAA -> TTTTGGCATGTTAAGAAAC
CCAGGTAACCTGGGGCCTC -> CAGGTAACCTGGGGCCTCG
CGAGTTATTGTTCTAGTTT -> GAGTTATTGTTCTAGTTTC
GGAAGCCTACACGGCTGAG -> GAAGCCTACACGGCTGAGG
TCGGAGGACCGTATCGGCT -> CGGAGGACCGTATCGGCTA
AACAGATGTAAACGGACGA -> ACAGATGTAAACGGACGAG
CGCTAGCGGAACAGATGTA -> GCTAGCGGAACAGATGTAA
GTTCTCCCATCGGTTCATC -> TTCTCCCATCGGTTCATCC
GGTAGCCAAGTTCCGATTC -> GTAGCCAAGTTCCGATTCC
AAGCCTACACGGCTGAGGG -> AGCCTACACGGCTGAGGGG
AGCCCCCGAGCAAGAGAAG -> GCCCCCGAGCAAGAGAAGT
ATAAGAATTTCAGAAAAAC -> TAAGAATTTCAGAAAAACA
TTCAACCATCCCGGCCATA -> TCAACCATCCCGGCCATAA
ACGTGTGCTGCAACACTAT -> CGTGTGCTGCAACACTATC
TCTCGCCGACTTCCAGCAA -> CTCGCCGACTTCCAGCAAA
ACGCCGTGTGCTTCTCCGA -> CGCCGTGTGCTTCTCCGAA
GTTTGGTCAGACGCCATCT -> TTTGGTCAGACGCCATCTA
CCGTGGAGCGGAGATGACG -> CGTGGAGCGGAGATGACGT
GAATATCTAAATCGTGTTA -> AATATCTAAATCGTGTTAC
CCGTCTTGGAAGCCTACAC -> CGTCTTGGAAGCCTACACG
CCTCCCTAAATATTAGATG -> CTCCCTAAATATTAGATGC
CACGCTCCCCTACCCGCGA -> ACGCTCCCCTACCCGCGAC
CTGGACGGAACAGTTTCCA -> TGGACGGAACAGTTTCCAC
AAATCGTGTTACCACCCGG -> AATCGTGTTACCACCCGGT
TATGGCGGTTGCCCTCGAT -> ATGGCGGTTGCCCTCGATT
AGCGGAACAGATGTAAACG -> GCGGAACAGATGTAAACGG
CTGATTACGCACGTAGTTG -> TGATTACGCACGTAGTTGA
TAGTATTAGCCGTCTTGGA -> AGTATTAGCCGTCTTGGAA
ATGAATAAATACTAGTATT -> TGAATAAATACTAGTATTA
AAATTCAACGCGGTCCGGA -> AATTCAACGCGGTCCGGAC
CCTCCCTATTATTTACGAG -> CTCCCTATTATTTACGAGG
TCATCCTTAACCCAAAGGT -> CATCCTTAACCCAAAGGTA
TTCGCTGAGGGACCGCATA -> TCGCTGAGGGACCGCATAA
CATCATCTCGAGTGGGATG -> ATCATCTCGAGTGGGATGT
GCCTGGTCGACCGGCTACA -> CCTGGTCGACCGGCTACAC
CTTGTGATGAGACAGGCGA -> TTGTGATGAGACAGGCGAT
AGTGTATAAGTGGGCCTGC -> GTGTATAAGTGGGCCTGCG
CCGTTTTCCACGAGTTATT -> CGTTTTCCACGAGTTATTG
CGCTAGCCCTAAGTTCTGG -> GCTAGCCCTAAGTTCTGGC
TCCGACGGCTTGTGATGAG -> CCGACGGCTTGTGATGAGA
CTCATCTAGGCGTCTATTT -> TCATCTAGGCGTCTATTTT
TCTCCGACGGCTTGTGATG -> CTCCGACGGCTTGTGATGA
TTCAGAAAAACACCTCACT -> TCAGAAAAACACCTCACTG
TGTGCCACGTGACCCAGGT -> GTGCCACGTGACCCAGGTA
GTGCCCATCCCATGGCGAC -> TGCCCATCCCATGGCGACA
TCTCGTCAGACCTCCACCA -> CTCGTCAGACCTCCACCAT
TTTCGCGGTCCGGACACCT -> TTCGCGGTCCGGACACCTC
ACCTCCACCATTGGCGATG -> CCTCCACCATTGGCGATGC
GACTTCCAGCAAAATCTCG -> ACTTCCAGCAAAATCTCGA
CTCTCTCCGACGGCTTGTG -> TCTCTCCGACGGCTTGTGA
GGCGATTTCTCACCCTACT -> GCGATTTCTCACCCTACTT
GTCTCATGGGGCAGAGTAA -> TCTCATGGGGCAGAGTAAG
ATAGGGACTCGCCTGGTCG -> TAGGGACTCGCCTGGTCGA
TGTTACCACCCGGTATGGG -> GTTACCACCCGGTATGGGA
GGTAGAATACGGTTAGCAT -> GTAGAATACGGTTAGCATA
TATTTACGAGGTTGTCCTG -> ATTTACGAGGTTGTCCTGA
TAGAATACGGTTAGCATAA -> AGAATACGGTTAGCATAAG
AATCGAGTACTACGTTTAA -> ATCGAGTACTACGTTTAAC
GTTCTGGCTCATGCTTTGA -> TTCTGGCTCATGCTTTGAC
ACCATCCCGGCCATAATGT -> CCATCCCGGCCATAATGTA
TGAGCGTCCGGGCCACCAG -> GAGCGTCCGGGCCACCAGA
ATTAGATGCTTAATAGGCG -> TTAGATGCTTAATAGGCGC
TATTTGTTCGTTACAAGAG -> ATTTGTTCGTTACAAGAGT
GCGTCTATTTTTTGGCATG -> CGTCTATTTTTTGGCATGT
CGGCTGGCTACTACTGCCG -> GGCTGGCTACTACTGCCGA
GTCGCCCTCGCCCAAATTT -> TCGCCCTCGCCCAAATTTG
ACCATCCGCAGAATTCTTA -> CCATCCGCAGAATTCTTAA
GCGCTCGTTGTCAACAAAG -> CGCTCGTTGTCAACAAAGT
ATCTAGGCGTCTATTTTTT -> TCTAGGCGTCTATTTTTTG
ATGCGACTTAATTTGACCT -> TGCGACTTAATTTGACCTC
AGTATTGGTTATGAATAAA -> GTATTGGTTATGAATAAAT
CCCGATGGACGGAGGAGGC -> CCGATGGACGGAGGAGGCT
AACCATCCGCAGAATTCTT -> ACCATCCGCAGAATTCTTA
GCAACACTAGTTTCACCTC -> CAACACTAGTTTCACCTCC
ATCTCGAGTGCCCATCCCA -> TCTCGAGTGCCCATCCCAT
TGACAGCCCCCGAGCAAGA -> GACAGCCCCCGAGCAAGAG
GCTAGCGGAACAGATGTAA -> CTAGCGGAACAGATGTAAA
CACCTCCCTAAATATTAGA -> ACCTCCCTAAATATTAGAT
TGGCTCATGCTTTGACTCA -> GGCTCATGCTTTGACTCAT
GTTCCGATTCCAAAGTCAT -> TTCCGATTCCAAAGTCATG
TCTTCCCGCTGTACGGGAG -> CTTCCCGCTGTACGGGAGG
TGCGTCCAATCGGAGGACC -> GCGTCCAATCGGAGGACCG
AAACACCTCACTGGGGTCT -> AACACCTCACTGGGGTCTT
TTTCCTGTGCATAGGCTCT -> TTCCTGTGCATAGGCTCTC
CTCCGACGGCTTGTGATGA -> TCCGACGGCTTGTGATGAG
GGTTGTCCTGAAAACGCCG -> GTTGTCCTGAAAACGCCGT
AACCCAAAGGTATAGGACT -> ACCCAAAGGTATAGGACTC
CCCATCGGTTCATCCTTAA -> CCATCGGTTCATCCTTAAC
