AAAAAGATTAA -> AAAAGATTAAC
AAAAAGCTCTC -> AAAAGCTCTCG
AAAACAATGGT -> AAACAATGGTA
AAAACCCGGGC -> AAACCCGGGCT
AAAACCGGCCC -> AAACCGGCCCC
AAAAGATTAAC -> AAAGATTAACG
AAAAGCTCTCG -> AAAGCTCTCGG
AAAAGTAGTAG -> AAAGTAGTAGT
AAAATCCGCCC -> AAATCCGCCCG
AAAATTACCTG -> AAATTACCTGG
AAACAATGGTA -> AACAATGGTAA
AAACAGGCTAT -> AACAGGCTATG
AAACATTTCCG -> AACATTTCCGC
AAACCCCAGAG -> AACCCCAGAGA
AAACCCGGGCT -> AACCCGGGCTC
AAACCCTTATA -> AACCCTTATAG
AAACCCTTCCA -> AACCCTTCCAG
AAACCGGCCCC -> AACCGGCCCCT
AAACTGACCGA -> AACTGACCGAA
AAAGACTTTAA -> AAGACTTTAAA
AAAGATTAACG -> AAGATTAACGT
AAAGCAATTGA -> AAGCAATTGAA
AAAGCCAGCGG -> AAGCCAGCGGA
AAAGCTCTCGG -> AAGCTCTCGGG
AAAGCTTTTTA -> AAGCTTTTTAT
AAAGGCAGACT -> AAGGCAGACTC
AAAGGCATAGG -> AAGGCATAGGG
AAAGTAATACG -> AAGTAATACGG
AAAGTAGTAGT -> AAGTAGTAGTA
AAAGTCGAATC -> AAGTCGAATCA
AAATATGAAAT -> AATATGAAATG
AAATCCCTTAG -> AATCCCTTAGA
AAATCCGCCCG -> AATCCGCCCGC
AAATGAGGCAG -> AATGAGGCAGA
AAATGCACAGC -> AATGCACAGCA
AAATGGATACA -> AATGGATACAG
AAATGTTGACC -> AATGTTGACCT
AAATTACCTGG -> AATTACCTGGT
AACAATGGTAA -> ACAATGGTAAA
AACAGGCTATG -> ACAGGCTATGG
AACATCTGGAT -> ACATCTGGATT
AACATTTCCGC -> ACATTTCCGCC
AACCAGGGGCT -> ACCAGGGGCTG
AACCCCAGAGA -> ACCCCAGAGAC
AACCCGGGCTC -> ACCCGGGCTCT
AACCCGGTTAC -> ACCCGGTTACG
AACCCTTAACC -> ACCCTTAACCA
AACCCTTATAG -> ACCCTTATAGA
AACCCTTCCAG -> ACCCTTCCAGT
AACCGATAACG -> ACCGATAACGC
AACCGGCCCCT -> ACCGGCCCCTC
AACCGTCCGCC -> ACCGTCCGCCA
AACCGTGTCCA -> ACCGTGTCCAA
AACGCGCCTGG -> ACGCGCCTGGG
AACGCTGGGCA -> ACGCTGGGCAA
AACGGTGCTGG -> ACGGTGCTGGA
AACGTTAATAT -> ACGTTAATATG
AACGTTTCACG -> ACGTTTCACGT
AACTAAAATCC -> ACTAAAATCCG
AACTCTATTCG -> ACTCTATTCGC
AACTGACCGAA -> ACTGACCGAAA
AACTGGGACCC -> ACTGGGACCCC
AACTTGGTTCC -> ACTTGGTTCCG
AAGAAATCCCT -> AGAAATCCCTT
AAGAAATGGAT -> AGAAATGGATA
AAGACCCTCCA -> AGACCCTCCAT
AAGACCGGACA -> AGACCGGACAG
AAGACTTTAAA -> AGACTTTAAAC
AAGATAAACCC -> AGATAAACCCC
AAGATTAACGT -> AGATTAACGTT
AAGCAACTCTA -> AGCAACTCTAT
AAGCAATTGAA -> AGCAATTGAAA
AAGCCAATGCC -> AGCCAATGCCG
AAGCCAGCGGA -> AGCCAGCGGAG
AAGCCCAATCC -> AGCCCAATCCG
AAGCGATGGTC -> AGCGATGGTCC
AAGCGTGACCA -> AGCGTGACCAC
AAGCTCTCGGG -> AGCTCTCGGGA
AAGCTTTTTAT -> AGCTTTTTATA
AAGGAACCGTC -> AGGAACCGTCC
AAGGCAGACTC -> AGGCAGACTCA
AAGGCATAGGG -> AGGCATAGGGA
AAGGCGACACA -> AGGCGACACAC
AAGGGGGCGAG -> AGGGGGCGAGG
AAGGTCGAAAG -> AGGTCGAAAGT
AAGGTGGCGGT -> AGGTGGCGGTA
AAGTAATACGG -> AGTAATACGGC
AAGTACGACGG -> AGTACGACGGC
AAGTAGTAGTA -> AGTAGTAGTAA
AAGTCGAATCA -> AGTCGAATCAG
AAGTCTAGCGT -> AGTCTAGCGTT
AAGTGAGACGC -> AGTGAGACGCC
AAGTGCACCAG -> AGTGCACCAGC
AAGTGCTGAGG -> AGTGCTGAGGT
AAGTGCTTATG -> AGTGCTTATGT
AATACAGATGG -> ATACAGATGGA
AATACGGCAGA -> ATACGGCAGAC
AATAGAGCGCT -> ATAGAGCGCTT
AATAGCGCGCG -> ATAGCGCGCGG
AATATAGAGCG -> ATATAGAGCGA
AATATGAAATG -> ATATGAAATGT
AATCAGCCCAC -> ATCAGCCCACA
AATCCAAGTGC -> ATCCAAGTGCT
AATCCATAAAG -> ATCCATAAAGG
AATCCCTTAGA -> ATCCCTTAGAA
AATCCGACGAC -> ATCCGACGACT
AATCCGCCCGC -> ATCCGCCCGCG
AATCGTCTATT -> ATCGTCTATTG
AATCTCAAGGC -> ATCTCAAGGCG
AATGAGGCAGA -> ATGAGGCAGAG
AATGCACAGCA -> ATGCACAGCAG
AATGCCGACAG -> ATGCCGACAGT
AATGCGACGGA -> ATGCGACGGAG
AATGGATACAG -> ATGGATACAGT
AATGGATTCCG -> ATGGATTCCGT
AATGGTAAAAA -> ATGGTAAAAAG
AATGTAGTAAG -> ATGTAGTAAGA
AATGTGTCCCA -> ATGTGTCCCAA
AATGTTGACCT -> ATGTTGACCTA
AATTACCTGGT -> ATTACCTGGTT
AATTGAAACAT -> ATTGAAACATT
ACAAAAGTAGT -> CAAAAGTAGTA
ACAACTAAAAT -> CAACTAAAATC
ACAAGTGAGAC -> CAAGTGAGACG
ACAATGGTAAA -> CAATGGTAAAA
ACACAAGTGAG -> CACAAGTGAGA
ACACACATACG -> CACACATACGG
ACACATACGGA -> CACATACGGAG
ACACATAGCAC -> CACATAGCACA
ACACCACCCAT -> CACCACCCATT
ACACCTTTCGC -> CACCTTTCGCT
ACAGATGGAGT -> CAGATGGAGTC
ACAGCAGCAAG -> CAGCAGCAAGT
ACAGCTTTCGC -> CAGCTTTCGCA
ACAGGCTATGG -> CAGGCTATGGT
ACAGGGTGTAG -> CAGGGTGTAGC
ACAGTCGTACC -> CAGTCGTACCT
ACAGTGATCAC -> CAGTGATCACA
ACAGTTATGCT -> CAGTTATGCTT
ACATACGAAAA -> CATACGAAAAC
ACATACGGAGC -> CATACGGAGCG
ACATAGCACAT -> CATAGCACATA
ACATATTATTA -> CATATTATTAG
ACATCAAACTG -> CATCAAACTGA
ACATCTGGATT -> CATCTGGATTC
ACATTTCACTC -> CATTTCACTCC
ACATTTCCGCC -> CATTTCCGCCA
ACCACCCATAT -> CCACCCATATA
ACCACCCATTC -> CCACCCATTCG
ACCACGGTTAT -> CCACGGTTATC
ACCAGATCTTG -> CCAGATCTTGC
ACCAGCTGTTC -> CCAGCTGTTCT
ACCAGGACACC -> CCAGGACACCA
ACCAGGGGCTG -> CCAGGGGCTGA
ACCATTAAAGA -> CCATTAAAGAC
ACCATTCACGT -> CCATTCACGTC
ACCCAAGCCCA -> CCCAAGCCCAA
ACCCATATAGA -> CCCATATAGAT
ACCCATCCGAT -> CCCATCCGATA
ACCCATTCGAT -> CCCATTCGATG
ACCCATTCGGA -> CCCATTCGGAA
ACCCCAGAGAC -> CCCCAGAGACT
ACCCCCAGTGC -> CCCCCAGTGCG
ACCCGGGCTCT -> CCCGGGCTCTG
ACCCGGTTACG -> CCCGGTTACGC
ACCCTCCATTC -> CCCTCCATTCC
ACCCTGAACGT -> CCCTGAACGTT
ACCCTTAACCA -> CCCTTAACCAG
ACCCTTATAGA -> CCCTTATAGAG
ACCCTTCCAGT -> CCCTTCCAGTT
ACCGAAATGCA -> CCGAAATGCAC
ACCGATAACGC -> CCGATAACGCG
ACCGCCGACCA -> CCGCCGACCAT
ACCGCTAAAAA -> CCGCTAAAAAG
ACCGGACAACT -> CCGGACAACTA
ACCGGACAGGG -> CCGGACAGGGT
ACCGGATCCCC -> CCGGATCCCCT
ACCGGCCCCTC -> CCGGCCCCTCG
ACCGTCCGCCA -> CCGTCCGCCAT
ACCGTCTATCG -> CCGTCTATCGA
ACCGTGTCCAA -> CCGTGTCCAAC
ACCGTTTGTGC -> CCGTTTGTGCT
ACCTAGGTAAT -> CCTAGGTAATC
ACCTATTGGTA -> CCTATTGGTAT
ACCTGAAGGAA -> CCTGAAGGAAC
ACCTGGTTTAC -> CCTGGTTTACC
ACCTTATAGCT -> CCTTATAGCTA
ACCTTTCGCTC -> CCTTTCGCTCG
ACGAAAACAAT -> CGAAAACAATG
ACGACCGGACA -> CGACCGGACAA
ACGACGGCCAT -> CGACGGCCATC
ACGACTGGTTC -> CGACTGGTTCC
ACGAGAAACCC -> CGAGAAACCCT
ACGAGGTAGTG -> CGAGGTAGTGT
ACGATCCTGCG -> CGATCCTGCGT
ACGCAATGCGA -> CGCAATGCGAC
ACGCCGTTAAC -> CGCCGTTAACT
ACGCCTAGGTA -> CGCCTAGGTAG
ACGCCTGATAG -> CGCCTGATAGT
ACGCGCCTGGG -> CGCGCCTGGGG
ACGCTGCACTG -> CGCTGCACTGC
ACGCTGGGCAA -> CGCTGGGCAAT
ACGCTGTGTTA -> CGCTGTGTTAG
ACGCTTTACTA -> CGCTTTACTAA
ACGGAGCACGC -> CGGAGCACGCT
ACGGAGCGCGG -> CGGAGCGCGGT
ACGGAGCTCCG -> CGGAGCTCCGA
ACGGCAGACGT -> CGGCAGACGTA
ACGGCCATCTT -> CGGCCATCTTC
ACGGTGCTGGA -> CGGTGCTGGAT
ACGGTTATCCC -> CGGTTATCCCC
ACGTATTGCTC -> CGTATTGCTCA
ACGTCACATTT -> CGTCACATTTC
ACGTTAATATG -> CGTTAATATGA
ACGTTGCCTTT -> CGTTGCCTTTT
ACGTTTAGCAC -> CGTTTAGCACT
ACGTTTCACGT -> CGTTTCACGTT
ACTAAAATCCG -> CTAAAATCCGC
ACTAAGATAAA -> CTAAGATAAAC
ACTAAGGTCGA -> CTAAGGTCGAA
ACTAGAGCTGC -> CTAGAGCTGCT
ACTATAAGGGG -> CTATAAGGGGG
ACTCAAACAGG -> CTCAAACAGGC
ACTCACATCAA -> CTCACATCAAA
ACTCATAGTAT -> CTCATAGTATT
ACTCATCCACC -> CTCATCCACCC
ACTCCTATCGC -> CTCCTATCGCA
ACTCGAGTATA -> CTCGAGTATAC
ACTCTATTCGC -> CTCTATTCGCC
ACTGAAATGAG -> CTGAAATGAGG
ACTGACCGAAA -> CTGACCGAAAT
ACTGCAAGAAA -> CTGCAAGAAAT
ACTGGGACCCC -> CTGGGACCCCC
ACTGGTTCCCG -> CTGGTTCCCGA
ACTTGGTTCCG -> CTTGGTTCCGT
ACTTTAAACCC -> CTTTAAACCCT
AGAAACCCTTA -> GAAACCCTTAT
AGAAATCCCTT -> GAAATCCCTTA
AGAAATGGATA -> GAAATGGATAC
AGAACCGTGTC -> GAACCGTGTCC
AGAAGCCAATG -> GAAGCCAATGC
AGAAGCGTGAC -> GAAGCGTGACC
AGAAGGTGGCG -> GAAGGTGGCGG
AGAATACAGAT -> GAATACAGATG
AGACCCTCCAT -> GACCCTCCATT
AGACCGGACAG -> GACCGGACAGG
AGACCTTATAG -> GACCTTATAGC
AGACGCCTGAT -> GACGCCTGATA
AGACGTATTGC -> GACGTATTGCT
AGACTCACATC -> GACTCACATCA
AGACTCATCCA -> GACTCATCCAC
AGACTTTAAAC -> GACTTTAAACC
AGAGACTCACA -> GAGACTCACAT
AGAGCCGTTTT -> GAGCCGTTTTC
AGAGCGATCCT -> GAGCGATCCTC
AGAGCGCTTGA -> GAGCGCTTGAT
AGAGCGTATAG -> GAGCGTATAGC
AGAGCTGCTCT -> GAGCTGCTCTA
AGAGGTCCTGC -> GAGGTCCTGCT
AGAGGTCTAAT -> GAGGTCTAATG
AGATAAACCCC -> GATAAACCCCA
AGATACTCGAG -> GATACTCGAGT
AGATATCGATC -> GATATCGATCC
AGATATCGCCA -> GATATCGCCAA
AGATATGGTTG -> GATATGGTTGT
AGATCGGGCTG -> GATCGGGCTGC
AGATCTTGCGA -> GATCTTGCGAG
AGATGGAGTCG -> GATGGAGTCGT
AGATTAACGTT -> GATTAACGTTT
AGATTAGTACG -> GATTAGTACGC
AGATTGAGACC -> GATTGAGACCT
AGCAACTCTAT -> GCAACTCTATT
AGCAAGTCTAG -> GCAAGTCTAGC
AGCAAGTGCTG -> GCAAGTGCTGA
AGCAATTGAAA -> GCAATTGAAAC
AGCACATACGA -> GCACATACGAA
AGCACGCTTTA -> GCACGCTTTAC
AGCACTAAGGT -> GCACTAAGGTC
AGCACTAGAGC -> GCACTAGAGCT
AGCAGCAAGTG -> GCAGCAAGTGC
AGCATTCACGT -> GCATTCACGTT
AGCCAATGCCG -> GCCAATGCCGA
AGCCAGCGGAG -> GCCAGCGGAGG
AGCCCAATCCG -> GCCCAATCCGA
AGCCCACAGTT -> GCCCACAGTTA
AGCCCTTACGA -> GCCCTTACGAT
AGCCGTTTTCT -> GCCGTTTTCTT
AGCCTCGAAGA -> GCCTCGAAGAA
AGCGAGGGGGG -> GCGAGGGGGGC
AGCGATCCTCA -> GCGATCCTCAA
AGCGATGGTCC -> GCGATGGTCCT
AGCGATTTAGG -> GCGATTTAGGT
AGCGCGCGGTA -> GCGCGCGGTAC
AGCGCGGTCTA -> GCGCGGTCTAA
AGCGCTTGATC -> GCGCTTGATCA
AGCGGAGGACG -> GCGGAGGACGC
AGCGGTTCCTG -> GCGGTTCCTGC
AGCGTATAGCG -> GCGTATAGCGA
AGCGTGACCAC -> GCGTGACCACG
AGCGTTTAAAA -> GCGTTTAAAAC
AGCTACATATT -> GCTACATATTA
AGCTCCGACTC -> GCTCCGACTCA
AGCTCTCGGGA -> GCTCTCGGGAT
AGCTGCTCTAC -> GCTGCTCTACG
AGCTGTTCTTT -> GCTGTTCTTTT
AGCTTCTGTGC -> GCTTCTGTGCA
AGCTTTCGCAG -> GCTTTCGCAGC
AGCTTTTTATA -> GCTTTTTATAG
AGGAACCGTCC -> GGAACCGTCCG
AGGACAAAAGT -> GGACAAAAGTA
AGGACACCACC -> GGACACCACCC
AGGACCAGATC -> GGACCAGATCT
AGGACGCTGCA -> GGACGCTGCAC
AGGAGCAAGTC -> GGAGCAAGTCT
AGGAGCGAGGG -> GGAGCGAGGGG
AGGATCGCGCC -> GGATCGCGCCG
AGGCACCCTGA -> GGCACCCTGAA
AGGCAGACTCA -> GGCAGACTCAT
AGGCAGAGCGT -> GGCAGAGCGTA
AGGCATAGGGA -> GGCATAGGGAG
AGGCCCGCAAA -> GGCCCGCAAAG
AGGCGACACAC -> GGCGACACACA
AGGCTACCATT -> GGCTACCATTC
AGGCTATGGTT -> GGCTATGGTTA
AGGGAGGTGAG -> GGGAGGTGAGT
AGGGATCGAAA -> GGGATCGAAAG
AGGGGCTGATG -> GGGGCTGATGG
AGGGGGCGAGG -> GGGGGCGAGGA
AGGGGGGCTAG -> GGGGGGCTAGG
AGGGTGGGTGA -> GGGTGGGTGAA
AGGGTGTAGCC -> GGGTGTAGCCT
AGGTAATCCAT -> GGTAATCCATA
AGGTAGGTCTT -> GGTAGGTCTTT
AGGTAGTGTCC -> GGTAGTGTCCT
AGGTATATGCA -> GGTATATGCAT
AGGTCCTGCTA -> GGTCCTGCTAT
AGGTCCTGCTT -> GGTCCTGCTTC
AGGTCGAAAGT -> GGTCGAAAGTC
AGGTCGCGAAA -> GGTCGCGAAAT
AGGTCTAATGG -> GGTCTAATGGA
AGGTCTTTTGC -> GGTCTTTTGCA
AGGTGAGTTGG -> GGTGAGTTGGC
AGGTGGCGGTA -> GGTGGCGGTAG
AGGTTTCCGGA -> GGTTTCCGGAG
AGTAACCCTTA -> GTAACCCTTAA
AGTAAGACCCT -> GTAAGACCCTC
AGTAATACGGC -> GTAATACGGCA
AGTACGACGGC -> GTACGACGGCC
AGTACGCCTAG -> GTACGCCTAGG
AGTAGTAACCC -> GTAGTAACCCT
AGTAGTAGTAA -> GTAGTAGTAAC
AGTATACCGCC -> GTATACCGCCG
AGTATAGGGTG -> GTATAGGGTGG
AGTATTGAATC -> GTATTGAATCG
AGTATTTCCTC -> GTATTTCCTCA
AGTCATACGAG -> GTCATACGAGA
AGTCCCCGGGG -> GTCCCCGGGGG
AGTCGAATCAG -> GTCGAATCAGC
AGTCGTACCTA -> GTCGTACCTAT
AGTCGTCGAGA -> GTCGTCGAGAT
AGTCTAGCGTT -> GTCTAGCGTTT
AGTCTTATGAT -> GTCTTATGATC
AGTGACGCAAT -> GTGACGCAATG
AGTGAGACGCC -> GTGAGACGCCT
AGTGATCACAC -> GTGATCACACA
AGTGCACCAGC -> GTGCACCAGCT
AGTGCGGTTGG -> GTGCGGTTGGA
AGTGCTGAGGT -> GTGCTGAGGTA
AGTGCTTATGT -> GTGCTTATGTT
AGTGTCCTTAG -> GTGTCCTTAGG
AGTTAAGCGAT -> GTTAAGCGATG
AGTTAGAATAC -> GTTAGAATACA
AGTTATGCTTT -> GTTATGCTTTG
AGTTGAGCCCT -> GTTGAGCCCTT
AGTTGGCCAAT -> GTTGGCCAATA
AGTTGGGGGAG -> GTTGGGGGAGT
ATAAACCCCAG -> TAAACCCCAGA
ATAAAGGCAGA -> TAAAGGCAGAC
ATAACGCGCCT -> TAACGCGCCTG
ATAAGGGGGCG -> TAAGGGGGCGA
ATACAGATGGA -> TACAGATGGAG
ATACAGTCGTA -> TACAGTCGTAC
ATACCGCCGAC -> TACCGCCGACC
ATACGAAAACA -> TACGAAAACAA
ATACGAGAAAC -> TACGAGAAACC
ATACGCCGTTA -> TACGCCGTTAA
ATACGGAGCGC -> TACGGAGCGCG
ATACGGCAGAC -> TACGGCAGACG
ATACTCGAGTA -> TACTCGAGTAT
ATAGAACCGTG -> TAGAACCGTGT
ATAGAAGGTGG -> TAGAAGGTGGC
ATAGAGCGATC -> TAGAGCGATCC
ATAGAGCGCTT -> TAGAGCGCTTG
ATAGAGGTCCT -> TAGAGGTCCTG
ATAGATATCGC -> TAGATATCGCC
ATAGATCGGGC -> TAGATCGGGCT
ATAGCACATAC -> TAGCACATACG
ATAGCGATTTA -> TAGCGATTTAG
ATAGCGCGCGG -> TAGCGCGCGGT
ATAGCTACATA -> TAGCTACATAT
ATAGGATCGCG -> TAGGATCGCGC
ATAGGGAGGTG -> TAGGGAGGTGA
ATAGGGTGGGT -> TAGGGTGGGTG
ATAGTATAGGG -> TAGTATAGGGT
ATAGTATTGAA -> TAGTATTGAAT
ATATAGAGCGA -> TATAGAGCGAT
ATATAGATATC -> TATAGATATCG
ATATCGATCCT -> TATCGATCCTC
ATATCGCCAAC -> TATCGCCAACG
ATATGAAATGT -> TATGAAATGTT
ATATGCATAGG -> TATGCATAGGA
ATATGGTTGTC -> TATGGTTGTCC
ATATGTCCGGG -> TATGTCCGGGA
ATATTATTAGG -> TATTATTAGGA
ATCAAACTGAC -> TCAAACTGACC
ATCAAAGCTTT -> TCAAAGCTTTT
ATCAAAGTAAT -> TCAAAGTAATA
ATCACACATAG -> TCACACATAGC
ATCACGACCGG -> TCACGACCGGA
ATCAGCCCACA -> TCAGCCCACAG
ATCCAAGTGCT -> TCCAAGTGCTT
ATCCACCCATT -> TCCACCCATTC
ATCCATAAAGG -> TCCATAAAGGC
ATCCCCACCTG -> TCCCCACCTGA
ATCCCCTCTGC -> TCCCCTCTGCC
ATCCCTTAGAA -> TCCCTTAGAAG
ATCCGACGACT -> TCCGACGACTG
ATCCGATACGC -> TCCGATACGCC
ATCCGCCCGCG -> TCCGCCCGCGC
ATCCTCAATAG -> TCCTCAATAGC
ATCCTCAGTCC -> TCCTCAGTCCC
ATCCTGCGTTA -> TCCTGCGTTAT
ATCCTGTAAGT -> TCCTGTAAGTG
ATCGAAAGGCA -> TCGAAAGGCAT
ATCGAGTCTTA -> TCGAGTCTTAT
ATCGATCCTCA -> TCGATCCTCAG
ATCGCAAAGCA -> TCGCAAAGCAA
ATCGCCAACGG -> TCGCCAACGGT
ATCGCGCCGTA -> TCGCGCCGTAC
ATCGCTGGTCA -> TCGCTGGTCAT
ATCGGCGGTGA -> TCGGCGGTGAG
ATCGGGCTGCT -> TCGGGCTGCTT
ATCGTCTATTG -> TCGTCTATTGT
ATCTCAAGGCG -> TCTCAAGGCGA
ATCTGGATTCC -> TCTGGATTCCA
ATCTTCTGCCC -> TCTTCTGCCCT
ATCTTGCGAGC -> TCTTGCGAGCT
ATGAAATGTTG -> TGAAATGTTGA
ATGACTGAAAT -> TGACTGAAATG
ATGAGGCAGAG -> TGAGGCAGAGC
ATGATCCTGTA -> TGATCCTGTAA
ATGATTTTTTT -> TGATTTTTTTT
ATGCACAGCAG -> TGCACAGCAGC
ATGCATAGGAT -> TGCATAGGATC
ATGCCGACAGT -> TGCCGACAGTG
ATGCGACGGAG -> TGCGACGGAGC
ATGCGCAAGAC -> TGCGCAAGACC
ATGCTTTGTCT -> TGCTTTGTCTA
ATGGACCACCC -> TGGACCACCCA
ATGGAGTCGTC -> TGGAGTCGTCG
ATGGATACAGT -> TGGATACAGTC
ATGGATTCCGT -> TGGATTCCGTG
ATGGTAAAAAG -> TGGTAAAAAGA
ATGGTCCTATA -> TGGTCCTATAG
ATGGTTACCGT -> TGGTTACCGTT
ATGGTTGTCCA -> TGGTTGTCCAT
ATGGTTTCAAT -> TGGTTTCAATG
ATGTAACCCGG -> TGTAACCCGGT
ATGTAGTAAGA -> TGTAGTAAGAC
ATGTCCGGGAT -> TGTCCGGGATG
ATGTGTCCCAA -> TGTGTCCCAAC
ATGTTAGATAT -> TGTTAGATATG
ATGTTGACCTA -> TGTTGACCTAG
ATGTTTTTACC -> TGTTTTTACCG
ATTAAAGACTT -> TTAAAGACTTT
ATTAACGTTTC -> TTAACGTTTCA
ATTACCTGGTT -> TTACCTGGTTT
ATTAGGAGCGA -> TTAGGAGCGAG
ATTAGTACGCC -> TTAGTACGCCT
ATTATTAGGAG -> TTATTAGGAGC
ATTCACGTCAC -> TTCACGTCACA
ATTCACGTTGC -> TTCACGTTGCC
ATTCCACCCAA -> TTCCACCCAAG
ATTCCGTGCAA -> TTCCGTGCAAA
ATTCCTCTCTG -> TTCCTCTCTGG
ATTCGATGCGC -> TTCGATGCGCA
ATTCGCCCCCC -> TTCGCCCCCCG
ATTCGGAACAT -> TTCGGAACATC
ATTGAAACATT -> TTGAAACATTT
ATTGAATCGTC -> TTGAATCGTCT
ATTGAGACCTT -> TTGAGACCTTA
ATTGCTCAGTT -> TTGCTCAGTTG
ATTGGTATTTC -> TTGGTATTTCA
ATTGTTGACAC -> TTGTTGACACA
ATTGTTTGAAC -> TTGTTTGAACT
ATTTAGGTTTC -> TTTAGGTTTCC
ATTTCACTCCT -> TTTCACTCCTA
ATTTCAGCGGT -> TTTCAGCGGTT
ATTTCCGCCAG -> TTTCCGCCAGT
ATTTCCTCATT -> TTTCCTCATTG
ATTTTTTTTCA -> TTTTTTTTCAG
CAAAACCGGCC -> AAAACCGGCCC
CAAAAGTAGTA -> AAAAGTAGTAG
CAAAATTACCT -> AAAATTACCTG
CAAACAGGCTA -> AAACAGGCTAT
CAAACTGACCG -> AAACTGACCGA
CAAAGCAATTG -> AAAGCAATTGA
CAAAGCCAGCG -> AAAGCCAGCGG
CAAAGCTTTTT -> AAAGCTTTTTA
CAAAGTAATAC -> AAAGTAATACG
CAACCGATAAC -> AACCGATAACG
CAACGCTGGGC -> AACGCTGGGCA
CAACGGTGCTG -> AACGGTGCTGG
CAACTAAAATC -> AACTAAAATCC
CAACTCTATTC -> AACTCTATTCG
CAAGAAATGGA -> AAGAAATGGAT
CAAGACCGGAC -> AAGACCGGACA
CAAGCCCAATC -> AAGCCCAATCC
CAAGGCGACAC -> AAGGCGACACA
CAAGTCTAGCG -> AAGTCTAGCGT
CAAGTGAGACG -> AAGTGAGACGC
CAAGTGCTGAG -> AAGTGCTGAGG
CAAGTGCTTAT -> AAGTGCTTATG
CAATAGAGCGC -> AATAGAGCGCT
CAATAGCGCGC -> AATAGCGCGCG
CAATCCAAGTG -> AATCCAAGTGC
CAATCCGACGA -> AATCCGACGAC
CAATGCCGACA -> AATGCCGACAG
CAATGCGACGG -> AATGCGACGGA
CAATGGTAAAA -> AATGGTAAAAA
CAATGTGTCCC -> AATGTGTCCCA
CAATTGAAACA -> AATTGAAACAT
CACAAGTGAGA -> ACAAGTGAGAC
CACACATACGG -> ACACATACGGA
CACACATAGCA -> ACACATAGCAC
CACACCTTTCG -> ACACCTTTCGC
CACAGCAGCAA -> ACAGCAGCAAG
CACAGTTATGC -> ACAGTTATGCT
CACATACGAAA -> ACATACGAAAA
CACATACGGAG -> ACATACGGAGC
CACATAGCACA -> ACATAGCACAT
CACATCAAACT -> ACATCAAACTG
CACATTTCACT -> ACATTTCACTC
CACCACCCATT -> ACCACCCATTC
CACCAGCTGTT -> ACCAGCTGTTC
CACCCAAGCCC -> ACCCAAGCCCA
CACCCATATAG -> ACCCATATAGA
CACCCATTCGA -> ACCCATTCGAT
CACCCATTCGG -> ACCCATTCGGA
CACCCTGAACG -> ACCCTGAACGT
CACCTGAAGGA -> ACCTGAAGGAA
CACCTTTCGCT -> ACCTTTCGCTC
CACGACCGGAC -> ACGACCGGACA
CACGCTTTACT -> ACGCTTTACTA
CACGGTTATCC -> ACGGTTATCCC
CACGTCACATT -> ACGTCACATTT
CACGTTGCCTT -> ACGTTGCCTTT
CACGTTTAGCA -> ACGTTTAGCAC
CACTAAGGTCG -> ACTAAGGTCGA
CACTAGAGCTG -> ACTAGAGCTGC
CACTCAAACAG -> ACTCAAACAGG
CACTCCTATCG -> ACTCCTATCGC
CACTGCAAGAA -> ACTGCAAGAAA
CAGAAGCCAAT -> AGAAGCCAATG
CAGACGTATTG -> AGACGTATTGC
CAGACTCATCC -> AGACTCATCCA
CAGAGACTCAC -> AGAGACTCACA
CAGAGCGTATA -> AGAGCGTATAG
CAGATATCGAT -> AGATATCGATC
CAGATCTTGCG -> AGATCTTGCGA
CAGATGGAGTC -> AGATGGAGTCG
CAGCAAGTGCT -> AGCAAGTGCTG
CAGCACTAAGG -> AGCACTAAGGT
CAGCAGCAAGT -> AGCAGCAAGTG
CAGCCCACAGT -> AGCCCACAGTT
CAGCGGAGGAC -> AGCGGAGGACG
CAGCGGTTCCT -> AGCGGTTCCTG
CAGCTGTTCTT -> AGCTGTTCTTT
CAGCTTTCGCA -> AGCTTTCGCAG
CAGGACACCAC -> AGGACACCACC
CAGGACCAGAT -> AGGACCAGATC
CAGGCACCCTG -> AGGCACCCTGA
CAGGCCCGCAA -> AGGCCCGCAAA
CAGGCTATGGT -> AGGCTATGGTT
CAGGGGCTGAT -> AGGGGCTGATG
CAGGGTGTAGC -> AGGGTGTAGCC
CAGGTCCTGCT -> AGGTCCTGCTA
CAGTATTTCCT -> AGTATTTCCTC
CAGTCCCCGGG -> AGTCCCCGGGG
CAGTCGTACCT -> AGTCGTACCTA
CAGTGATCACA -> AGTGATCACAC
CAGTGCGGTTG -> AGTGCGGTTGG
CAGTTATGCTT -> AGTTATGCTTT
CAGTTGAGCCC -> AGTTGAGCCCT
CAGTTGGGGGA -> AGTTGGGGGAG
CATAAAGGCAG -> ATAAAGGCAGA
CATACGAAAAC -> ATACGAAAACA
CATACGAGAAA -> ATACGAGAAAC
CATACGGAGCG -> ATACGGAGCGC
CATAGCACATA -> ATAGCACATAC
CATAGGATCGC -> ATAGGATCGCG
CATAGGGAGGT -> ATAGGGAGGTG
CATAGTATTGA -> ATAGTATTGAA
CATATAGATAT -> ATATAGATATC
CATATGTCCGG -> ATATGTCCGGG
CATATTATTAG -> ATATTATTAGG
CATCAAACTGA -> ATCAAACTGAC
CATCACGACCG -> ATCACGACCGG
CATCCACCCAT -> ATCCACCCATT
CATCCGATACG -> ATCCGATACGC
CATCTGGATTC -> ATCTGGATTCC
CATCTTCTGCC -> ATCTTCTGCCC
CATGACTGAAA -> ATGACTGAAAT
CATGGACCACC -> ATGGACCACCC
CATTAAAGACT -> ATTAAAGACTT
CATTCACGTCA -> ATTCACGTCAC
CATTCACGTTG -> ATTCACGTTGC
CATTCCTCTCT -> ATTCCTCTCTG
CATTCGATGCG -> ATTCGATGCGC
CATTCGGAACA -> ATTCGGAACAT
CATTGTTGACA -> ATTGTTGACAC
CATTTCACTCC -> ATTTCACTCCT
CATTTCCGCCA -> ATTTCCGCCAG
CCAAAATTACC -> CAAAATTACCT
CCAACCGATAA -> CAACCGATAAC
CCAACGCTGGG -> CAACGCTGGGC
CCAACGGTGCT -> CAACGGTGCTG
CCAAGCCCAAT -> CAAGCCCAATC
CCAAGTGCTTA -> CAAGTGCTTAT
CCAATAGAGCG -> CAATAGAGCGC
CCAATCCGACG -> CAATCCGACGA
CCAATGCCGAC -> CAATGCCGACA
CCACAGTTATG -> CACAGTTATGC
CCACCCAAGCC -> CACCCAAGCCC
CCACCCATATA -> CACCCATATAG
CCACCCATTCG -> CACCCATTCGG, CACCCATTCGA
CCACCTGAAGG -> CACCTGAAGGA
CCACGGTTATC -> CACGGTTATCC
CCAGAGACTCA -> CAGAGACTCAC
CCAGATCTTGC -> CAGATCTTGCG
CCAGCGGAGGA -> CAGCGGAGGAC
CCAGCTGTTCT -> CAGCTGTTCTT
CCAGGACACCA -> CAGGACACCAC
CCAGGCCCGCA -> CAGGCCCGCAA
CCAGGGGCTGA -> CAGGGGCTGAT
CCAGTATTTCC -> CAGTATTTCCT
CCAGTGCGGTT -> CAGTGCGGTTG
CCAGTTGGGGG -> CAGTTGGGGGA
CCATAAAGGCA -> CATAAAGGCAG
CCATATAGATA -> CATATAGATAT
CCATATGTCCG -> CATATGTCCGG
CCATCACGACC -> CATCACGACCG
CCATCCGATAC -> CATCCGATACG
CCATCTTCTGC -> CATCTTCTGCC
CCATTAAAGAC -> CATTAAAGACT
CCATTCACGTC -> CATTCACGTCA
CCATTCCTCTC -> CATTCCTCTCT
CCATTCGATGC -> CATTCGATGCG
CCATTCGGAAC -> CATTCGGAACA
CCCAACGCTGG -> CCAACGCTGGG
CCCAAGCCCAA -> CCAAGCCCAAT
CCCAATCCGAC -> CCAATCCGACG
CCCACAGTTAT -> CCACAGTTATG
CCCACCTGAAG -> CCACCTGAAGG
CCCAGAGACTC -> CCAGAGACTCA
CCCAGTGCGGT -> CCAGTGCGGTT
CCCATATAGAT -> CCATATAGATA
CCCATCCGATA -> CCATCCGATAC
CCCATTCGATG -> CCATTCGATGC
CCCATTCGGAA -> CCATTCGGAAC
CCCCACCTGAA -> CCCACCTGAAG
CCCCAGAGACT -> CCCAGAGACTC
CCCCAGTGCGG -> CCCAGTGCGGT
CCCCCAGTGCG -> CCCCAGTGCGG
CCCCCCGAGAG -> CCCCCGAGAGC
CCCCCGAGAGC -> CCCCGAGAGCC
CCCCGAGAGCC -> CCCGAGAGCCG
CCCCGGGGGTC -> CCCGGGGGTCA
CCCCTCGCTGC -> CCCTCGCTGCG
CCCCTCTGCCG -> CCCTCTGCCGC
CCCGAGAGCCG -> CCGAGAGCCGT
CCCGAGTGACG -> CCGAGTGACGC
CCCGCAAAGCC -> CCGCAAAGCCA
CCCGCGCGGTA -> CCGCGCGGTAG
CCCGGGCTCTG -> CCGGGCTCTGA
CCCGGGGGTCA -> CCGGGGGTCAG
CCCGGTTACGC -> CCGGTTACGCT
CCCTCCATTCC -> CCTCCATTCCT
CCCTCGCTGCG -> CCTCGCTGCGT
CCCTCGTCAGA -> CCTCGTCAGAT
CCCTCTGCCGC -> CCTCTGCCGCT
CCCTGAACGTT -> CCTGAACGTTA
CCCTTAACCAG -> CCTTAACCAGG
CCCTTACGATC -> CCTTACGATCC
CCCTTAGAAGC -> CCTTAGAAGCG
CCCTTATAGAG -> CCTTATAGAGG
CCCTTCCAGTT -> CCTTCCAGTTG
CCGAAATGCAC -> CGAAATGCACA
CCGACAGTGAT -> CGACAGTGATC
CCGACCATTAA -> CGACCATTAAA
CCGACGACTGG -> CGACGACTGGT
CCGACTCATAG -> CGACTCATAGT
CCGAGAGCCGT -> CGAGAGCCGTT
CCGAGTGACGC -> CGAGTGACGCA
CCGATAACGCG -> CGATAACGCGC
CCGATACGCCG -> CGATACGCCGT
CCGCAAAGCCA -> CGCAAAGCCAG
CCGCCAGTATT -> CGCCAGTATTT
CCGCCATATGT -> CGCCATATGTC
CCGCCCGCGCG -> CGCCCGCGCGG
CCGCCGACCAT -> CGCCGACCATT
CCGCGCGGTAG -> CGCGCGGTAGC
CCGCTAAAAAG -> CGCTAAAAAGC
CCGCTGCACAC -> CGCTGCACACC
CCGGACAACTA -> CGGACAACTAA
CCGGACAGGGT -> CGGACAGGGTG
CCGGAGTTAGA -> CGGAGTTAGAA
CCGGATCCCCT -> CGGATCCCCTC
CCGGCCCCTCG -> CGGCCCCTCGC
CCGGGATGTAA -> CGGGATGTAAC
CCGGGCTCTGA -> CGGGCTCTGAC
CCGGGGACCAG -> CGGGGACCAGG
CCGGGGGTCAG -> CGGGGGTCAGG
CCGGTTACGCT -> CGGTTACGCTG
CCGTACAGCTT -> CGTACAGCTTT
CCGTCCGCCAT -> CGTCCGCCATA
CCGTCTATCGA -> CGTCTATCGAG
CCGTGCAAAAC -> CGTGCAAAACC
CCGTGTCCAAC -> CGTGTCCAACC
CCGTTAACTGG -> CGTTAACTGGG
CCGTTCTCAGG -> CGTTCTCAGGA
CCGTTTGTGCT -> CGTTTGTGCTT
CCGTTTTCTTG -> CGTTTTCTTGG
CCTAGGTAATC -> CTAGGTAATCC
CCTAGGTAGGT -> CTAGGTAGGTC
CCTATAGAAGG -> CTATAGAAGGT
CCTATCGCAAA -> CTATCGCAAAG
CCTATTGGTAT -> CTATTGGTATT
CCTCAATAGCG -> CTCAATAGCGC
CCTCAGTCCCC -> CTCAGTCCCCG
CCTCATTGTTG -> CTCATTGTTGA
CCTCCATTCCT -> CTCCATTCCTC
CCTCGAAGAAA -> CTCGAAGAAAT
CCTCGCTGCGT -> CTCGCTGCGTT
CCTCGTCAGAT -> CTCGTCAGATA
CCTCTCAGGTC -> CTCTCAGGTCC
CCTCTCTGGTT -> CTCTCTGGTTC
CCTCTGCCGCT -> CTCTGCCGCTG
CCTGAACGTTA -> CTGAACGTTAA
CCTGAAGGAAC -> CTGAAGGAACC
CCTGATAGTAT -> CTGATAGTATA
CCTGCGTTATC -> CTGCGTTATCA
CCTGCTATCGG -> CTGCTATCGGC
CCTGCTGGGAA -> CTGCTGGGAAT
CCTGCTTCGCT -> CTGCTTCGCTG
CCTGGGGACCC -> CTGGGGACCCA
CCTGGTTTACC -> CTGGTTTACCG
CCTGTAAGTGC -> CTGTAAGTGCA
CCTTAACCAGG -> CTTAACCAGGG
CCTTACGATCC -> CTTACGATCCT
CCTTAGAAGCG -> CTTAGAAGCGT
CCTTAGGTCGC -> CTTAGGTCGCG
CCTTATAGAGG -> CTTATAGAGGT
CCTTATAGCTA -> CTTATAGCTAC
CCTTCCAGTTG -> CTTCCAGTTGG
CCTTTCGCTCG -> CTTTCGCTCGT
CCTTTTATGTT -> CTTTTATGTTT
CGAAAACAATG -> GAAAACAATGG
CGAAAGGCATA -> GAAAGGCATAG
CGAAAGTCGAA -> GAAAGTCGAAT
CGAAATATGAA -> GAAATATGAAA
CGAAATGCACA -> GAAATGCACAG
CGAAGAAATCC -> GAAGAAATCCC
CGAATCAGCCC -> GAATCAGCCCA
CGACACACATA -> GACACACATAC
CGACAGTGATC -> GACAGTGATCA
CGACCATTAAA -> GACCATTAAAG
CGACCGGACAA -> GACCGGACAAC
CGACGACTGGT -> GACGACTGGTT
CGACGGAGCTC -> GACGGAGCTCC
CGACGGCCATC -> GACGGCCATCT
CGACTCATAGT -> GACTCATAGTA
CGACTGGTTCC -> GACTGGTTCCC
CGAGAAACCCT -> GAGAAACCCTT
CGAGAGCCGTT -> GAGAGCCGTTT
CGAGATTGAGA -> GAGATTGAGAC
CGAGCTTCTGT -> GAGCTTCTGTG
CGAGGACAAAA -> GAGGACAAAAG
CGAGGGGGGCT -> GAGGGGGGCTA
CGAGGTAGTGT -> GAGGTAGTGTC
CGAGTATACCG -> GAGTATACCGC
CGAGTCTTATG -> GAGTCTTATGA
CGAGTGACGCA -> GAGTGACGCAA
CGATAACGCGC -> GATAACGCGCC
CGATACGCCGT -> GATACGCCGTT
CGATCCTCAAT -> GATCCTCAATA
CGATCCTCAGT -> GATCCTCAGTC
CGATCCTGCGT -> GATCCTGCGTT
CGATGCGCAAG -> GATGCGCAAGA
CGATGGTCCTA -> GATGGTCCTAT
CGATTTAGGTT -> GATTTAGGTTT
CGCAAAGCAAT -> GCAAAGCAATT
CGCAAAGCCAG -> GCAAAGCCAGC
CGCAAGACCGG -> GCAAGACCGGA
CGCAATGCGAC -> GCAATGCGACG
CGCAGCACTAA -> GCAGCACTAAG
CGCCAACGGTG -> GCCAACGGTGC
CGCCAGTATTT -> GCCAGTATTTC
CGCCATATGTC -> GCCATATGTCC
CGCCCCCCGAG -> GCCCCCCGAGA
CGCCCGCGCGG -> GCCCGCGCGGT
CGCCGACCATT -> GCCGACCATTA
CGCCGTACAGC -> GCCGTACAGCT
CGCCGTTAACT -> GCCGTTAACTG
CGCCTAGGTAG -> GCCTAGGTAGG
CGCCTGATAGT -> GCCTGATAGTA
CGCCTGGGGAC -> GCCTGGGGACC
CGCGAAATATG -> GCGAAATATGA
CGCGCCGTACA -> GCGCCGTACAG
CGCGCCTGGGG -> GCGCCTGGGGA
CGCGCGGTACC -> GCGCGGTACCG
CGCGCGGTAGC -> GCGCGGTAGCA
CGCGGTACCGC -> GCGGTACCGCT
CGCGGTAGCAT -> GCGGTAGCATT
CGCGGTCTAAG -> GCGGTCTAAGC
CGCTAAAAAGC -> GCTAAAAAGCT
CGCTCGTGGTC -> GCTCGTGGTCC
CGCTGCACACC -> GCTGCACACCT
CGCTGCACTGC -> GCTGCACTGCA
CGCTGCGTTGA -> GCTGCGTTGAG
CGCTGGAATGT -> GCTGGAATGTA
CGCTGGGCAAT -> GCTGGGCAATC
CGCTGGTCATG -> GCTGGTCATGG
CGCTGTGTTAG -> GCTGTGTTAGA
CGCTTGATCAA -> GCTTGATCAAA
CGCTTTACTAA -> GCTTTACTAAG
CGGAACATCTG -> GGAACATCTGG
CGGACAACTAA -> GGACAACTAAA
CGGACAGGGTG -> GGACAGGGTGT
CGGAGCACGCT -> GGAGCACGCTT
CGGAGCGCGGT -> GGAGCGCGGTC
CGGAGCTCCGA -> GGAGCTCCGAC
CGGAGGACGCT -> GGAGGACGCTG
CGGAGTTAGAA -> GGAGTTAGAAT
CGGATCCCCTC -> GGATCCCCTCT
CGGCAGACGTA -> GGCAGACGTAT
CGGCCATCTTC -> GGCCATCTTCT
CGGCCCCTCGC -> GGCCCCTCGCT
CGGCGGTGAGT -> GGCGGTGAGTT
CGGGATAGATC -> GGGATAGATCG
CGGGATGTAAC -> GGGATGTAACC
CGGGCTCTGAC -> GGGCTCTGACT
CGGGCTGCTTT -> GGGCTGCTTTG
CGGGGACCAGG -> GGGGACCAGGA
CGGGGGTCAGG -> GGGGGTCAGGC
CGGTACCGCTA -> GGTACCGCTAA
CGGTAGATACT -> GGTAGATACTC
CGGTAGCATTC -> GGTAGCATTCA
CGGTCTAAGCA -> GGTCTAAGCAA
CGGTGAGTTAA -> GGTGAGTTAAG
CGGTGCTGGAT -> GGTGCTGGATG
CGGTTACGCTG -> GGTTACGCTGT
CGGTTATCCCC -> GGTTATCCCCA
CGGTTCCTGCT -> GGTTCCTGCTG
CGGTTGGAGAG -> GGTTGGAGAGG
CGTACAGCTTT -> GTACAGCTTTC
CGTACCTATTG -> GTACCTATTGG
CGTATAGCGAT -> GTATAGCGATT
CGTATTGCTCA -> GTATTGCTCAG
CGTCACATTTC -> GTCACATTTCA
CGTCAGATATC -> GTCAGATATCG
CGTCCGCCATA -> GTCCGCCATAT
CGTCGAGATTG -> GTCGAGATTGA
CGTCTATCGAG -> GTCTATCGAGT
CGTCTATTGTT -> GTCTATTGTTT
CGTGACCACGG -> GTGACCACGGT
CGTGCAAAACC -> GTGCAAAACCG
CGTGGTCCGGG -> GTGGTCCGGGG
CGTGTCCAACC -> GTGTCCAACCG
CGTTAACTGGG -> GTTAACTGGGA
CGTTAATATGA -> GTTAATATGAT
CGTTATCAAAG -> GTTATCAAAGC
CGTTCTCAGGA -> GTTCTCAGGAC
CGTTGAGGCTA -> GTTGAGGCTAC
CGTTGCCTTTT -> GTTGCCTTTTA
CGTTTAAAACC -> GTTTAAAACCC
CGTTTAGCACT -> GTTTAGCACTA
CGTTTCACGTT -> GTTTCACGTTT
CGTTTGTGCTT -> GTTTGTGCTTC
CGTTTTCTTGG -> GTTTTCTTGGA
CTAAAAAGCTC -> TAAAAAGCTCT
CTAAAATCCGC -> TAAAATCCGCC
CTAAGATAAAC -> TAAGATAAACC
CTAAGCAACTC -> TAAGCAACTCT
CTAAGGTCGAA -> TAAGGTCGAAA
CTAATGGATTC -> TAATGGATTCC
CTACATATTAT -> TACATATTATT
CTACCATTCAC -> TACCATTCACG
CTACGAGGTAG -> TACGAGGTAGT
CTACGGAGCAC -> TACGGAGCACG
CTAGAGCTGCT -> TAGAGCTGCTC
CTAGCGTTTAA -> TAGCGTTTAAA
CTAGGGATCGA -> TAGGGATCGAA
CTAGGTAATCC -> TAGGTAATCCA
CTAGGTAGGTC -> TAGGTAGGTCT
CTATAAGGGGG -> TATAAGGGGGC
CTATAGAAGGT -> TATAGAAGGTG
CTATCGAGTCT -> TATCGAGTCTT
CTATCGCAAAG -> TATCGCAAAGC
CTATCGGCGGT -> TATCGGCGGTG
CTATGGTTACC -> TATGGTTACCG
CTATTCGCCCC -> TATTCGCCCCC
CTATTGGTATT -> TATTGGTATTT
CTATTGTTTGA -> TATTGTTTGAA
CTCAAACAGGC -> TCAAACAGGCT
CTCAAGGCGAC -> TCAAGGCGACA
CTCAATAGCGC -> TCAATAGCGCG
CTCACATCAAA -> TCACATCAAAC
CTCAGGACCAG -> TCAGGACCAGA
CTCAGGTCCTG -> TCAGGTCCTGC
CTCAGTCCCCG -> TCAGTCCCCGG
CTCAGTTGAGC -> TCAGTTGAGCC
CTCATAGTATT -> TCATAGTATTG
CTCATCCACCC -> TCATCCACCCA
CTCATTGTTGA -> TCATTGTTGAC
CTCCATTCCTC -> TCCATTCCTCT
CTCCGACTCAT -> TCCGACTCATA
CTCCTATCGCA -> TCCTATCGCAA
CTCGAAGAAAT -> TCGAAGAAATC
CTCGAGTATAC -> TCGAGTATACC
CTCGCTGCGTT -> TCGCTGCGTTG
CTCGGGATAGA -> TCGGGATAGAT
CTCGTCAGATA -> TCGTCAGATAT
CTCGTGGTCCG -> TCGTGGTCCGG
CTCTACGGAGC -> TCTACGGAGCA
CTCTATTCGCC -> TCTATTCGCCC
CTCTCAGGTCC -> TCTCAGGTCCT
CTCTCGGGATA -> TCTCGGGATAG
CTCTCTGGTTC -> TCTCTGGTTCC
CTCTGACTATA -> TCTGACTATAA
CTCTGCCGCTG -> TCTGCCGCTGC
CTCTGGTTCCA -> TCTGGTTCCAA
CTGAAATGAGG -> TGAAATGAGGC
CTGAACGTTAA -> TGAACGTTAAT
CTGAAGGAACC -> TGAAGGAACCG
CTGACCGAAAT -> TGACCGAAATG
CTGACTATAAG -> TGACTATAAGG
CTGAGGTATAT -> TGAGGTATATG
CTGATAGTATA -> TGATAGTATAG
CTGATGGTTTC -> TGATGGTTTCA
CTGCAAGAAAT -> TGCAAGAAATG
CTGCACACCTT -> TGCACACCTTT
CTGCACTGCAA -> TGCACTGCAAG
CTGCCCTCGTC -> TGCCCTCGTCA
CTGCCGCTGCA -> TGCCGCTGCAC
CTGCGTTATCA -> TGCGTTATCAA
CTGCGTTGAGG -> TGCGTTGAGGC
CTGCTATCGGC -> TGCTATCGGCG
CTGCTCTACGG -> TGCTCTACGGA
CTGCTGGGAAT -> TGCTGGGAATA
CTGCTTCGCTG -> TGCTTCGCTGG
CTGCTTTGAAG -> TGCTTTGAAGT
CTGGAATGTAG -> TGGAATGTAGT
CTGGATGATTT -> TGGATGATTTT
CTGGATTCCAC -> TGGATTCCACC
CTGGGAATATA -> TGGGAATATAG
CTGGGACCCCC -> TGGGACCCCCA
CTGGGCAATCC -> TGGGCAATCCA
CTGGGGACCCA -> TGGGGACCCAT
CTGGTCATGGA -> TGGTCATGGAC
CTGGTTCCAAA -> TGGTTCCAAAA
CTGGTTCCCGA -> TGGTTCCCGAG
CTGGTTTACCG -> TGGTTTACCGG
CTGTAAGTGCA -> TGTAAGTGCAC
CTGTGCATGAC -> TGTGCATGACT
CTGTGTTAGAT -> TGTGTTAGATT
CTGTTCTTTTT -> TGTTCTTTTTT
CTTAACCAGGG -> TTAACCAGGGG
CTTACGATCCT -> TTACGATCCTG
CTTAGAAGCGT -> TTAGAAGCGTG
CTTAGGTCGCG -> TTAGGTCGCGA
CTTATAGAGGT -> TTATAGAGGTC
CTTATAGCTAC -> TTATAGCTACA
CTTATGATCCT -> TTATGATCCTG
CTTATGTTAGA -> TTATGTTAGAT
CTTCCAGGCCC -> TTCCAGGCCCG
CTTCCAGTTGG -> TTCCAGTTGGG
CTTCGCTGGAA -> TTCGCTGGAAT
CTTCTGCCCTC -> TTCTGCCCTCG
CTTCTGTGCAT -> TTCTGTGCATG
CTTGATCAAAG -> TTGATCAAAGT
CTTGCGAGCTT -> TTGCGAGCTTC
CTTGGAGGAGC -> TTGGAGGAGCA
CTTGGTTCCGT -> TTGGTTCCGTT
CTTTAAACCCT -> TTTAAACCCTT
CTTTACTAAGA -> TTTACTAAGAT
CTTTCGCAGCA -> TTTCGCAGCAC
CTTTCGCTCGT -> TTTCGCTCGTG
CTTTGAAGTAC -> TTTGAAGTACG
CTTTGTCTACG -> TTTGTCTACGA
CTTTTATGTTT -> TTTTATGTTTT
CTTTTGCACTC -> TTTTGCACTCA
CTTTTTATAGA -> TTTTTATAGAA
CTTTTTTTCCT -> TTTTTTTCCTC
GAAAACAATGG -> AAAACAATGGT
GAAACATTTCC -> AAACATTTCCG
GAAACCCTTAT -> AAACCCTTATA
GAAAGGCATAG -> AAAGGCATAGG
GAAAGTCGAAT -> AAAGTCGAATC
GAAATATGAAA -> AAATATGAAAT
GAAATCCCTTA -> AAATCCCTTAG
GAAATGAGGCA -> AAATGAGGCAG
GAAATGCACAG -> AAATGCACAGC
GAAATGGATAC -> AAATGGATACA
GAAATGTTGAC -> AAATGTTGACC
GAACATCTGGA -> AACATCTGGAT
GAACCGTCCGC -> AACCGTCCGCC
GAACCGTGTCC -> AACCGTGTCCA
GAACGTTAATA -> AACGTTAATAT
GAACTTGGTTC -> AACTTGGTTCC
GAAGAAATCCC -> AAGAAATCCCT
GAAGCCAATGC -> AAGCCAATGCC
GAAGCGTGACC -> AAGCGTGACCA
GAAGGAACCGT -> AAGGAACCGTC
GAAGGTGGCGG -> AAGGTGGCGGT
GAAGTACGACG -> AAGTACGACGG
GAATACAGATG -> AATACAGATGG
GAATATAGAGC -> AATATAGAGCG
GAATCAGCCCA -> AATCAGCCCAC
GAATCGTCTAT -> AATCGTCTATT
GAATCTCAAGG -> AATCTCAAGGC
GAATGTAGTAA -> AATGTAGTAAG
GACAAAAGTAG -> ACAAAAGTAGT
GACAACTAAAA -> ACAACTAAAAT
GACACAAGTGA -> ACACAAGTGAG
GACACACATAC -> ACACACATACG
GACACCACCCA -> ACACCACCCAT
GACAGGGTGTA -> ACAGGGTGTAG
GACAGTGATCA -> ACAGTGATCAC
GACCACCCATA -> ACCACCCATAT
GACCACGGTTA -> ACCACGGTTAT
GACCAGATCTT -> ACCAGATCTTG
GACCAGGACAC -> ACCAGGACACC
GACCATTAAAG -> ACCATTAAAGA
GACCCATCCGA -> ACCCATCCGAT
GACCCCCAGTG -> ACCCCCAGTGC
GACCCTCCATT -> ACCCTCCATTC
GACCGAAATGC -> ACCGAAATGCA
GACCGGACAAC -> ACCGGACAACT
GACCGGACAGG -> ACCGGACAGGG
GACCTAGGTAA -> ACCTAGGTAAT
GACCTTATAGC -> ACCTTATAGCT
GACGACTGGTT -> ACGACTGGTTC
GACGCAATGCG -> ACGCAATGCGA
GACGCCTGATA -> ACGCCTGATAG
GACGCTGCACT -> ACGCTGCACTG
GACGGAGCTCC -> ACGGAGCTCCG
GACGGCCATCT -> ACGGCCATCTT
GACGTATTGCT -> ACGTATTGCTC
GACTATAAGGG -> ACTATAAGGGG
GACTCACATCA -> ACTCACATCAA
GACTCATAGTA -> ACTCATAGTAT
GACTCATCCAC -> ACTCATCCACC
GACTGAAATGA -> ACTGAAATGAG
GACTGGTTCCC -> ACTGGTTCCCG
GACTTTAAACC -> ACTTTAAACCC
GAGAAACCCTT -> AGAAACCCTTA
GAGACCTTATA -> AGACCTTATAG
GAGACGCCTGA -> AGACGCCTGAT
GAGACTCACAT -> AGACTCACATC
GAGAGCCGTTT -> AGAGCCGTTTT
GAGAGGTCTAA -> AGAGGTCTAAT
GAGATTGAGAC -> AGATTGAGACC
GAGCAAGTCTA -> AGCAAGTCTAG
GAGCACGCTTT -> AGCACGCTTTA
GAGCCCTTACG -> AGCCCTTACGA
GAGCCGTTTTC -> AGCCGTTTTCT
GAGCGAGGGGG -> AGCGAGGGGGG
GAGCGATCCTC -> AGCGATCCTCA
GAGCGCGGTCT -> AGCGCGGTCTA
GAGCGCTTGAT -> AGCGCTTGATC
GAGCGTATAGC -> AGCGTATAGCG
GAGCTCCGACT -> AGCTCCGACTC
GAGCTGCTCTA -> AGCTGCTCTAC
GAGCTTCTGTG -> AGCTTCTGTGC
GAGGACAAAAG -> AGGACAAAAGT
GAGGACGCTGC -> AGGACGCTGCA
GAGGAGCAAGT -> AGGAGCAAGTC
GAGGCAGAGCG -> AGGCAGAGCGT
GAGGCTACCAT -> AGGCTACCATT
GAGGGGGGCTA -> AGGGGGGCTAG
GAGGTAGTGTC -> AGGTAGTGTCC
GAGGTATATGC -> AGGTATATGCA
GAGGTCCTGCT -> AGGTCCTGCTT
GAGGTCTAATG -> AGGTCTAATGG
GAGGTGAGTTG -> AGGTGAGTTGG
GAGTATACCGC -> AGTATACCGCC
GAGTCATACGA -> AGTCATACGAG
GAGTCGTCGAG -> AGTCGTCGAGA
GAGTCTTATGA -> AGTCTTATGAT
GAGTGACGCAA -> AGTGACGCAAT
GAGTTAAGCGA -> AGTTAAGCGAT
GAGTTAGAATA -> AGTTAGAATAC
GAGTTGGCCAA -> AGTTGGCCAAT
GATAAACCCCA -> ATAAACCCCAG
GATAACGCGCC -> ATAACGCGCCT
GATACAGTCGT -> ATACAGTCGTA
GATACGCCGTT -> ATACGCCGTTA
GATACTCGAGT -> ATACTCGAGTA
GATAGATCGGG -> ATAGATCGGGC
GATAGTATAGG -> ATAGTATAGGG
GATATCGATCC -> ATATCGATCCT
GATATCGCCAA -> ATATCGCCAAC
GATATGGTTGT -> ATATGGTTGTC
GATCAAAGTAA -> ATCAAAGTAAT
GATCACACATA -> ATCACACATAG
GATCCCCTCTG -> ATCCCCTCTGC
GATCCTCAATA -> ATCCTCAATAG
GATCCTCAGTC -> ATCCTCAGTCC
GATCCTGCGTT -> ATCCTGCGTTA
GATCCTGTAAG -> ATCCTGTAAGT
GATCGAAAGGC -> ATCGAAAGGCA
GATCGCGCCGT -> ATCGCGCCGTA
GATCGGGCTGC -> ATCGGGCTGCT
GATCTTGCGAG -> ATCTTGCGAGC
GATGATTTTTT -> ATGATTTTTTT
GATGCGCAAGA -> ATGCGCAAGAC
GATGGAGTCGT -> ATGGAGTCGTC
GATGGTCCTAT -> ATGGTCCTATA
GATGGTTTCAA -> ATGGTTTCAAT
GATGTAACCCG -> ATGTAACCCGG
GATTAACGTTT -> ATTAACGTTTC
GATTAGTACGC -> ATTAGTACGCC
GATTCCACCCA -> ATTCCACCCAA
GATTCCGTGCA -> ATTCCGTGCAA
GATTGAGACCT -> ATTGAGACCTT
GATTTAGGTTT -> ATTTAGGTTTC
GATTTTTTTTC -> ATTTTTTTTCA
GCAAAACCGGC -> CAAAACCGGCC
GCAAAGCAATT -> CAAAGCAATTG
GCAAAGCCAGC -> CAAAGCCAGCG
GCAACTCTATT -> CAACTCTATTC
GCAAGAAATGG -> CAAGAAATGGA
GCAAGACCGGA -> CAAGACCGGAC
GCAAGTCTAGC -> CAAGTCTAGCG
GCAAGTGCTGA -> CAAGTGCTGAG
GCAATCCAAGT -> CAATCCAAGTG
GCAATGCGACG -> CAATGCGACGG
GCAATTGAAAC -> CAATTGAAACA
GCACACCTTTC -> CACACCTTTCG
GCACAGCAGCA -> CACAGCAGCAA
GCACATACGAA -> CACATACGAAA
GCACCAGCTGT -> CACCAGCTGTT
GCACCCTGAAC -> CACCCTGAACG
GCACGCTTTAC -> CACGCTTTACT
GCACTAAGGTC -> CACTAAGGTCG
GCACTAGAGCT -> CACTAGAGCTG
GCACTCAAACA -> CACTCAAACAG
GCACTGCAAGA -> CACTGCAAGAA
GCAGACGTATT -> CAGACGTATTG
GCAGACTCATC -> CAGACTCATCC
GCAGAGCGTAT -> CAGAGCGTATA
GCAGCAAGTGC -> CAGCAAGTGCT
GCAGCACTAAG -> CAGCACTAAGG
GCATAGGATCG -> CATAGGATCGC
GCATAGGGAGG -> CATAGGGAGGT
GCATGACTGAA -> CATGACTGAAA
GCATTCACGTT -> CATTCACGTTG
GCCAACGGTGC -> CCAACGGTGCT
GCCAATAGAGC -> CCAATAGAGCG
GCCAATGCCGA -> CCAATGCCGAC
GCCAGCGGAGG -> CCAGCGGAGGA
GCCAGTATTTC -> CCAGTATTTCC
GCCATATGTCC -> CCATATGTCCG
GCCATCTTCTG -> CCATCTTCTGC
GCCCAATCCGA -> CCCAATCCGAC
GCCCACAGTTA -> CCCACAGTTAT
GCCCCCCGAGA -> CCCCCCGAGAG
GCCCCTCGCTG -> CCCCTCGCTGC
GCCCGCAAAGC -> CCCGCAAAGCC
GCCCGCGCGGT -> CCCGCGCGGTA
GCCCTCGTCAG -> CCCTCGTCAGA
GCCCTTACGAT -> CCCTTACGATC
GCCGACAGTGA -> CCGACAGTGAT
GCCGACCATTA -> CCGACCATTAA
GCCGCTGCACA -> CCGCTGCACAC
GCCGTACAGCT -> CCGTACAGCTT
GCCGTTAACTG -> CCGTTAACTGG
GCCGTTTTCTT -> CCGTTTTCTTG
GCCTAGGTAGG -> CCTAGGTAGGT
GCCTCGAAGAA -> CCTCGAAGAAA
GCCTGATAGTA -> CCTGATAGTAT
GCCTGGGGACC -> CCTGGGGACCC
GCCTTTTATGT -> CCTTTTATGTT
GCGAAATATGA -> CGAAATATGAA
GCGACACACAT -> CGACACACATA
GCGACGGAGCT -> CGACGGAGCTC
GCGAGCTTCTG -> CGAGCTTCTGT
GCGAGGACAAA -> CGAGGACAAAA
GCGAGGGGGGC -> CGAGGGGGGCT
GCGATCCTCAA -> CGATCCTCAAT
GCGATGGTCCT -> CGATGGTCCTA
GCGATTTAGGT -> CGATTTAGGTT
GCGCAAGACCG -> CGCAAGACCGG
GCGCCGTACAG -> CGCCGTACAGC
GCGCCTGGGGA -> CGCCTGGGGAC
GCGCGCGGTAC -> CGCGCGGTACC
GCGCGGTACCG -> CGCGGTACCGC
GCGCGGTAGCA -> CGCGGTAGCAT
GCGCGGTCTAA -> CGCGGTCTAAG
GCGCTTGATCA -> CGCTTGATCAA
GCGGAGGACGC -> CGGAGGACGCT
GCGGTACCGCT -> CGGTACCGCTA
GCGGTAGATAC -> CGGTAGATACT
GCGGTAGCATT -> CGGTAGCATTC
GCGGTCTAAGC -> CGGTCTAAGCA
GCGGTGAGTTA -> CGGTGAGTTAA
GCGGTTCCTGC -> CGGTTCCTGCT
GCGGTTGGAGA -> CGGTTGGAGAG
GCGTATAGCGA -> CGTATAGCGAT
GCGTGACCACG -> CGTGACCACGG
GCGTTATCAAA -> CGTTATCAAAG
GCGTTGAGGCT -> CGTTGAGGCTA
GCGTTTAAAAC -> CGTTTAAAACC
GCTAAAAAGCT -> CTAAAAAGCTC
GCTACATATTA -> CTACATATTAT
GCTACCATTCA -> CTACCATTCAC
GCTAGGGATCG -> CTAGGGATCGA
GCTATCGGCGG -> CTATCGGCGGT
GCTATGGTTAC -> CTATGGTTACC
GCTCAGTTGAG -> CTCAGTTGAGC
GCTCCGACTCA -> CTCCGACTCAT
GCTCGTGGTCC -> CTCGTGGTCCG
GCTCTACGGAG -> CTCTACGGAGC
GCTCTCGGGAT -> CTCTCGGGATA
GCTCTGACTAT -> CTCTGACTATA
GCTGAGGTATA -> CTGAGGTATAT
GCTGATGGTTT -> CTGATGGTTTC
GCTGCACACCT -> CTGCACACCTT
GCTGCACTGCA -> CTGCACTGCAA
GCTGCGTTGAG -> CTGCGTTGAGG
GCTGCTCTACG -> CTGCTCTACGG
GCTGCTTTGAA -> CTGCTTTGAAG
GCTGGAATGTA -> CTGGAATGTAG
GCTGGATGATT -> CTGGATGATTT
GCTGGGAATAT -> CTGGGAATATA
GCTGGGCAATC -> CTGGGCAATCC
GCTGGTCATGG -> CTGGTCATGGA
GCTGTGTTAGA -> CTGTGTTAGAT
GCTGTTCTTTT -> CTGTTCTTTTT
GCTTATGTTAG -> CTTATGTTAGA
GCTTCCAGGCC -> CTTCCAGGCCC
GCTTCGCTGGA -> CTTCGCTGGAA
GCTTCTGTGCA -> CTTCTGTGCAT
GCTTGATCAAA -> CTTGATCAAAG
GCTTTACTAAG -> CTTTACTAAGA
GCTTTCGCAGC -> CTTTCGCAGCA
GCTTTGAAGTA -> CTTTGAAGTAC
GCTTTGTCTAC -> CTTTGTCTACG
GCTTTTTATAG -> CTTTTTATAGA
GGAACATCTGG -> GAACATCTGGA
GGAACCGTCCG -> GAACCGTCCGC
GGAATATAGAG -> GAATATAGAGC
GGAATGTAGTA -> GAATGTAGTAA
GGACAAAAGTA -> GACAAAAGTAG
GGACAACTAAA -> GACAACTAAAA
GGACACCACCC -> GACACCACCCA
GGACAGGGTGT -> GACAGGGTGTA
GGACCACCCAT -> GACCACCCATA
GGACCAGATCT -> GACCAGATCTT
GGACCAGGACA -> GACCAGGACAC
GGACCCATCCG -> GACCCATCCGA
GGACCCCCAGT -> GACCCCCAGTG
GGACGCTGCAC -> GACGCTGCACT
GGAGAGGTCTA -> GAGAGGTCTAA
GGAGCAAGTCT -> GAGCAAGTCTA
GGAGCACGCTT -> GAGCACGCTTT
GGAGCGAGGGG -> GAGCGAGGGGG
GGAGCGCGGTC -> GAGCGCGGTCT
GGAGCTCCGAC -> GAGCTCCGACT
GGAGGACGCTG -> GAGGACGCTGC
GGAGGAGCAAG -> GAGGAGCAAGT
GGAGGTGAGTT -> GAGGTGAGTTG
GGAGTCATACG -> GAGTCATACGA
GGAGTCGTCGA -> GAGTCGTCGAG
GGAGTTAGAAT -> GAGTTAGAATA
GGATACAGTCG -> GATACAGTCGT
GGATAGATCGG -> GATAGATCGGG
GGATCCCCTCT -> GATCCCCTCTG
GGATCGAAAGG -> GATCGAAAGGC
GGATCGCGCCG -> GATCGCGCCGT
GGATGATTTTT -> GATGATTTTTT
GGATGTAACCC -> GATGTAACCCG
GGATTCCACCC -> GATTCCACCCA
GGATTCCGTGC -> GATTCCGTGCA
GGCAATCCAAG -> GCAATCCAAGT
GGCACCCTGAA -> GCACCCTGAAC
GGCAGACGTAT -> GCAGACGTATT
GGCAGACTCAT -> GCAGACTCATC
GGCAGAGCGTA -> GCAGAGCGTAT
GGCATAGGGAG -> GCATAGGGAGG
GGCCAATAGAG -> GCCAATAGAGC
GGCCATCTTCT -> GCCATCTTCTG
GGCCCCTCGCT -> GCCCCTCGCTG
GGCCCGCAAAG -> GCCCGCAAAGC
GGCGACACACA -> GCGACACACAT
GGCGAGGACAA -> GCGAGGACAAA
GGCGGTAGATA -> GCGGTAGATAC
GGCGGTGAGTT -> GCGGTGAGTTA
GGCTACCATTC -> GCTACCATTCA
GGCTAGGGATC -> GCTAGGGATCG
GGCTATGGTTA -> GCTATGGTTAC
GGCTCTGACTA -> GCTCTGACTAT
GGCTGATGGTT -> GCTGATGGTTT
GGCTGCTTTGA -> GCTGCTTTGAA
GGGAATATAGA -> GGAATATAGAG
GGGACCAGGAC -> GGACCAGGACA
GGGACCCATCC -> GGACCCATCCG
GGGACCCCCAG -> GGACCCCCAGT
GGGAGGTGAGT -> GGAGGTGAGTT
GGGAGTCATAC -> GGAGTCATACG
GGGATAGATCG -> GGATAGATCGG
GGGATCGAAAG -> GGATCGAAAGG
GGGATGTAACC -> GGATGTAACCC
GGGCAATCCAA -> GGCAATCCAAG
GGGCGAGGACA -> GGCGAGGACAA
GGGCTAGGGAT -> GGCTAGGGATC
GGGCTCTGACT -> GGCTCTGACTA
GGGCTGATGGT -> GGCTGATGGTT
GGGCTGCTTTG -> GGCTGCTTTGA
GGGGACCAGGA -> GGGACCAGGAC
GGGGACCCATC -> GGGACCCATCC
GGGGAGTCATA -> GGGAGTCATAC
GGGGCGAGGAC -> GGGCGAGGACA
GGGGCTAGGGA -> GGGCTAGGGAT
GGGGCTGATGG -> GGGCTGATGGT
GGGGGAGTCAT -> GGGGAGTCATA
GGGGGCGAGGA -> GGGGCGAGGAC
GGGGGCTAGGG -> GGGGCTAGGGA
GGGGGGCTAGG -> GGGGGCTAGGG
GGGGGTCAGGC -> GGGGTCAGGCA
GGGGTCAGGCA -> GGGTCAGGCAC
GGGTCAGGCAC -> GGTCAGGCACC
GGGTGAATCTC -> GGTGAATCTCA
GGGTGGGTGAA -> GGTGGGTGAAT
GGGTGTAGCCT -> GGTGTAGCCTC
GGTAAAAAGAT -> GTAAAAAGATT
GGTAATCCATA -> GTAATCCATAA
GGTACCGCTAA -> GTACCGCTAAA
GGTAGATACTC -> GTAGATACTCG
GGTAGCATTCA -> GTAGCATTCAC
GGTAGGTCTTT -> GTAGGTCTTTT
GGTAGTGTCCT -> GTAGTGTCCTT
GGTATATGCAT -> GTATATGCATA
GGTATTTCAGC -> GTATTTCAGCG
GGTCAGGCACC -> GTCAGGCACCC
GGTCATGGACC -> GTCATGGACCA
GGTCCGGGGAC -> GTCCGGGGACC
GGTCCTATAGA -> GTCCTATAGAA
GGTCCTGCTAT -> GTCCTGCTATC
GGTCCTGCTTC -> GTCCTGCTTCG
GGTCGAAAGTC -> GTCGAAAGTCG
GGTCGCGAAAT -> GTCGCGAAATA
GGTCTAAGCAA -> GTCTAAGCAAC
GGTCTAATGGA -> GTCTAATGGAT
GGTCTTTTGCA -> GTCTTTTGCAC
GGTGAATCTCA -> GTGAATCTCAA
GGTGAGTTAAG -> GTGAGTTAAGC
GGTGAGTTGGC -> GTGAGTTGGCC
GGTGCTGGATG -> GTGCTGGATGA
GGTGGCGGTAG -> GTGGCGGTAGA
GGTGGGTGAAT -> GTGGGTGAATC
GGTGTAGCCTC -> GTGTAGCCTCG
GGTTACCGTTT -> GTTACCGTTTG
GGTTACGCTGT -> GTTACGCTGTG
GGTTATCCCCA -> GTTATCCCCAC
GGTTCCAAAAT -> GTTCCAAAATT
GGTTCCCGAGT -> GTTCCCGAGTG
GGTTCCGTTCT -> GTTCCGTTCTC
GGTTCCTGCTG -> GTTCCTGCTGG
GGTTGGAGAGG -> GTTGGAGAGGT
GGTTGTCCATC -> GTTGTCCATCA
GGTTTACCGGA -> GTTTACCGGAT
GGTTTCAATGT -> GTTTCAATGTG
GGTTTCCGGAG -> GTTTCCGGAGT
GTAAAAAGATT -> TAAAAAGATTA
GTAACCCGGTT -> TAACCCGGTTA
GTAACCCTTAA -> TAACCCTTAAC
GTAAGACCCTC -> TAAGACCCTCC
GTAAGTGCACC -> TAAGTGCACCA
GTAATACGGCA -> TAATACGGCAG
GTAATCCATAA -> TAATCCATAAA
GTACAGCTTTC -> TACAGCTTTCG
GTACCGCTAAA -> TACCGCTAAAA
GTACCTATTGG -> TACCTATTGGT
GTACGACGGCC -> TACGACGGCCA
GTACGCCTAGG -> TACGCCTAGGT
GTAGATACTCG -> TAGATACTCGA
GTAGCATTCAC -> TAGCATTCACG
GTAGCCTCGAA -> TAGCCTCGAAG
GTAGGTCTTTT -> TAGGTCTTTTG
GTAGTAACCCT -> TAGTAACCCTT
GTAGTAAGACC -> TAGTAAGACCC
GTAGTAGTAAC -> TAGTAGTAACC
GTAGTGTCCTT -> TAGTGTCCTTA
GTATACCGCCG -> TATACCGCCGA
GTATAGCGATT -> TATAGCGATTT
GTATAGGGTGG -> TATAGGGTGGG
GTATATGCATA -> TATATGCATAG
GTATTGAATCG -> TATTGAATCGT
GTATTGCTCAG -> TATTGCTCAGT
GTATTTCAGCG -> TATTTCAGCGG
GTATTTCCTCA -> TATTTCCTCAT
GTCACATTTCA -> TCACATTTCAC
GTCAGATATCG -> TCAGATATCGA
GTCAGGCACCC -> TCAGGCACCCT
GTCATACGAGA -> TCATACGAGAA
GTCATGGACCA -> TCATGGACCAC
GTCCAACCGAT -> TCCAACCGATA
GTCCATCACGA -> TCCATCACGAC
GTCCCAACGCT -> TCCCAACGCTG
GTCCCCGGGGG -> TCCCCGGGGGT
GTCCGCCATAT -> TCCGCCATATG
GTCCGGGATGT -> TCCGGGATGTA
GTCCGGGGACC -> TCCGGGGACCA
GTCCTATAGAA -> TCCTATAGAAG
GTCCTGCTATC -> TCCTGCTATCG
GTCCTGCTTCG -> TCCTGCTTCGC
GTCCTTAGGTC -> TCCTTAGGTCG
GTCGAAAGTCG -> TCGAAAGTCGA
GTCGAATCAGC -> TCGAATCAGCC
GTCGAGATTGA -> TCGAGATTGAG
GTCGCGAAATA -> TCGCGAAATAT
GTCGTACCTAT -> TCGTACCTATT
GTCGTCGAGAT -> TCGTCGAGATT
GTCTAAGCAAC -> TCTAAGCAACT
GTCTAATGGAT -> TCTAATGGATT
GTCTACGAGGT -> TCTACGAGGTA
GTCTAGCGTTT -> TCTAGCGTTTA
GTCTATCGAGT -> TCTATCGAGTC
GTCTATTGTTT -> TCTATTGTTTG
GTCTTATGATC -> TCTTATGATCC
GTCTTTTGCAC -> TCTTTTGCACT
GTGAATCTCAA -> TGAATCTCAAG
GTGACCACGGT -> TGACCACGGTT
GTGACGCAATG -> TGACGCAATGC
GTGAGACGCCT -> TGAGACGCCTG
GTGAGTTAAGC -> TGAGTTAAGCG
GTGAGTTGGCC -> TGAGTTGGCCA
GTGATCACACA -> TGATCACACAT
GTGCAAAACCG -> TGCAAAACCGG
GTGCACCAGCT -> TGCACCAGCTG
GTGCATGACTG -> TGCATGACTGA
GTGCGGTTGGA -> TGCGGTTGGAG
GTGCTGAGGTA -> TGCTGAGGTAT
GTGCTGGATGA -> TGCTGGATGAT
GTGCTTATGTT -> TGCTTATGTTA
GTGCTTCCAGG -> TGCTTCCAGGC
GTGGCGGTAGA -> TGGCGGTAGAT
GTGGGTGAATC -> TGGGTGAATCT
GTGGTCCGGGG -> TGGTCCGGGGA
GTGTAGCCTCG -> TGTAGCCTCGA
GTGTCCAACCG -> TGTCCAACCGA
GTGTCCCAACG -> TGTCCCAACGC
GTGTCCTTAGG -> TGTCCTTAGGT
GTGTTAGATTA -> TGTTAGATTAG
GTTAACTGGGA -> TTAACTGGGAC
GTTAAGCGATG -> TTAAGCGATGG
GTTAATATGAT -> TTAATATGATT
GTTACCGTTTG -> TTACCGTTTGT
GTTACGCTGTG -> TTACGCTGTGT
GTTAGAATACA -> TTAGAATACAG
GTTAGATATGG -> TTAGATATGGT
GTTAGATTAGT -> TTAGATTAGTA
GTTATCAAAGC -> TTATCAAAGCT
GTTATCCCCAC -> TTATCCCCACC
GTTATGCTTTG -> TTATGCTTTGT
GTTCCAAAATT -> TTCCAAAATTA
GTTCCCGAGTG -> TTCCCGAGTGA
GTTCCGTTCTC -> TTCCGTTCTCA
GTTCCTGCTGG -> TTCCTGCTGGG
GTTCTCAGGAC -> TTCTCAGGACC
GTTCTTTTTTT -> TTCTTTTTTTC
GTTGACACAAG -> TTGACACAAGT
GTTGACCTAGG -> TTGACCTAGGT
GTTGAGCCCTT -> TTGAGCCCTTA
GTTGAGGCTAC -> TTGAGGCTACC
GTTGCCTTTTA -> TTGCCTTTTAT
GTTGGAGAGGT -> TTGGAGAGGTC
GTTGGCCAATA -> TTGGCCAATAG
GTTGGGGGAGT -> TTGGGGGAGTC
GTTGTCCATCA -> TTGTCCATCAC
GTTTAAAACCC -> TTTAAAACCCG
GTTTACCGGAT -> TTTACCGGATC
GTTTAGCACTA -> TTTAGCACTAG
GTTTCAATGTG -> TTTCAATGTGT
GTTTCACGTTT -> TTTCACGTTTA
GTTTCCGGAGT -> TTTCCGGAGTT
GTTTGAACTTG -> TTTGAACTTGG
GTTTGTGCTTC -> TTTGTGCTTCC
GTTTTCTTGGA -> TTTTCTTGGAG
GTTTTTACCGT -> TTTTTACCGTC
TAAAAAGATTA -> AAAAAGATTAA
TAAAAAGCTCT -> AAAAAGCTCTC
TAAAACCCGGG -> AAAACCCGGGC
TAAAATCCGCC -> AAAATCCGCCC
TAAACCCCAGA -> AAACCCCAGAG
TAAACCCTTCC -> AAACCCTTCCA
TAAAGACTTTA -> AAAGACTTTAA
TAAAGGCAGAC -> AAAGGCAGACT
TAACCAGGGGC -> AACCAGGGGCT
TAACCCGGTTA -> AACCCGGTTAC
TAACCCTTAAC -> AACCCTTAACC
TAACGCGCCTG -> AACGCGCCTGG
TAACGTTTCAC -> AACGTTTCACG
TAACTGGGACC -> AACTGGGACCC
TAAGACCCTCC -> AAGACCCTCCA
TAAGATAAACC -> AAGATAAACCC
TAAGCAACTCT -> AAGCAACTCTA
TAAGCGATGGT -> AAGCGATGGTC
TAAGGGGGCGA -> AAGGGGGCGAG
TAAGGTCGAAA -> AAGGTCGAAAG
TAAGTGCACCA -> AAGTGCACCAG
TAATACGGCAG -> AATACGGCAGA
TAATCCATAAA -> AATCCATAAAG
TAATGGATTCC -> AATGGATTCCG
TACAGATGGAG -> ACAGATGGAGT
TACAGCTTTCG -> ACAGCTTTCGC
TACAGTCGTAC -> ACAGTCGTACC
TACATATTATT -> ACATATTATTA
TACCATTCACG -> ACCATTCACGT
TACCGCCGACC -> ACCGCCGACCA
TACCGCTAAAA -> ACCGCTAAAAA
TACCGGATCCC -> ACCGGATCCCC
TACCGTCTATC -> ACCGTCTATCG
TACCGTTTGTG -> ACCGTTTGTGC
TACCTATTGGT -> ACCTATTGGTA
TACCTGGTTTA -> ACCTGGTTTAC
TACGAAAACAA -> ACGAAAACAAT
TACGACGGCCA -> ACGACGGCCAT
TACGAGAAACC -> ACGAGAAACCC
TACGAGGTAGT -> ACGAGGTAGTG
TACGATCCTGC -> ACGATCCTGCG
TACGCCGTTAA -> ACGCCGTTAAC
TACGCCTAGGT -> ACGCCTAGGTA
TACGCTGTGTT -> ACGCTGTGTTA
TACGGAGCACG -> ACGGAGCACGC
TACGGAGCGCG -> ACGGAGCGCGG
TACGGCAGACG -> ACGGCAGACGT
TACTAAGATAA -> ACTAAGATAAA
TACTCGAGTAT -> ACTCGAGTATA
TAGAACCGTGT -> AGAACCGTGTC
TAGAAGCGTGA -> AGAAGCGTGAC
TAGAAGGTGGC -> AGAAGGTGGCG
TAGAATACAGA -> AGAATACAGAT
TAGAGCGATCC -> AGAGCGATCCT
TAGAGCGCTTG -> AGAGCGCTTGA
TAGAGCTGCTC -> AGAGCTGCTCT
TAGAGGTCCTG -> AGAGGTCCTGC
TAGATACTCGA -> AGATACTCGAG
TAGATATCGCC -> AGATATCGCCA
TAGATATGGTT -> AGATATGGTTG
TAGATCGGGCT -> AGATCGGGCTG
TAGATTAGTAC -> AGATTAGTACG
TAGCACATACG -> AGCACATACGA
TAGCACTAGAG -> AGCACTAGAGC
TAGCATTCACG -> AGCATTCACGT
TAGCCTCGAAG -> AGCCTCGAAGA
TAGCGATTTAG -> AGCGATTTAGG
TAGCGCGCGGT -> AGCGCGCGGTA
TAGCGTTTAAA -> AGCGTTTAAAA
TAGCTACATAT -> AGCTACATATT
TAGGAGCGAGG -> AGGAGCGAGGG
TAGGATCGCGC -> AGGATCGCGCC
TAGGGAGGTGA -> AGGGAGGTGAG
TAGGGATCGAA -> AGGGATCGAAA
TAGGGTGGGTG -> AGGGTGGGTGA
TAGGTAATCCA -> AGGTAATCCAT
TAGGTAGGTCT -> AGGTAGGTCTT
TAGGTCGCGAA -> AGGTCGCGAAA
TAGGTCTTTTG -> AGGTCTTTTGC
TAGGTTTCCGG -> AGGTTTCCGGA
TAGTAACCCTT -> AGTAACCCTTA
TAGTAAGACCC -> AGTAAGACCCT
TAGTACGCCTA -> AGTACGCCTAG
TAGTAGTAACC -> AGTAGTAACCC
TAGTATAGGGT -> AGTATAGGGTG
TAGTATTGAAT -> AGTATTGAATC
TAGTGTCCTTA -> AGTGTCCTTAG
TATAAGGGGGC -> ATAAGGGGGCG
TATACCGCCGA -> ATACCGCCGAC
TATAGAACCGT -> ATAGAACCGTG
TATAGAAGGTG -> ATAGAAGGTGG
TATAGAGCGAT -> ATAGAGCGATC
TATAGAGGTCC -> ATAGAGGTCCT
TATAGATATCG -> ATAGATATCGC
TATAGCGATTT -> ATAGCGATTTA
TATAGCTACAT -> ATAGCTACATA
TATAGGGTGGG -> ATAGGGTGGGT
TATATGCATAG -> ATATGCATAGG
TATCAAAGCTT -> ATCAAAGCTTT
TATCCCCACCT -> ATCCCCACCTG
TATCGAGTCTT -> ATCGAGTCTTA
TATCGATCCTC -> ATCGATCCTCA
TATCGCAAAGC -> ATCGCAAAGCA
TATCGCCAACG -> ATCGCCAACGG
TATCGGCGGTG -> ATCGGCGGTGA
TATGAAATGTT -> ATGAAATGTTG
TATGATCCTGT -> ATGATCCTGTA
TATGCATAGGA -> ATGCATAGGAT
TATGCTTTGTC -> ATGCTTTGTCT
TATGGTTACCG -> ATGGTTACCGT
TATGGTTGTCC -> ATGGTTGTCCA
TATGTCCGGGA -> ATGTCCGGGAT
TATGTTAGATA -> ATGTTAGATAT
TATGTTTTTAC -> ATGTTTTTACC
TATTAGGAGCG -> ATTAGGAGCGA
TATTATTAGGA -> ATTATTAGGAG
TATTCGCCCCC -> ATTCGCCCCCC
TATTGAATCGT -> ATTGAATCGTC
TATTGCTCAGT -> ATTGCTCAGTT
TATTGGTATTT -> ATTGGTATTTC
TATTGTTTGAA -> ATTGTTTGAAC
TATTTCAGCGG -> ATTTCAGCGGT
TATTTCCTCAT -> ATTTCCTCATT
TCAAACAGGCT -> CAAACAGGCTA
TCAAACTGACC -> CAAACTGACCG
TCAAAGCTTTT -> CAAAGCTTTTT
TCAAAGTAATA -> CAAAGTAATAC
TCAAGGCGACA -> CAAGGCGACAC
TCAATAGCGCG -> CAATAGCGCGC
TCAATGTGTCC -> CAATGTGTCCC
TCACACATAGC -> CACACATAGCA
TCACATCAAAC -> CACATCAAACT
TCACATTTCAC -> CACATTTCACT
TCACGACCGGA -> CACGACCGGAC
TCACGTCACAT -> CACGTCACATT
TCACGTTGCCT -> CACGTTGCCTT
TCACGTTTAGC -> CACGTTTAGCA
TCACTCCTATC -> CACTCCTATCG
TCAGAAGCCAA -> CAGAAGCCAAT
TCAGATATCGA -> CAGATATCGAT
TCAGCCCACAG -> CAGCCCACAGT
TCAGCGGTTCC -> CAGCGGTTCCT
TCAGGACCAGA -> CAGGACCAGAT
TCAGGCACCCT -> CAGGCACCCTG
TCAGGTCCTGC -> CAGGTCCTGCT
TCAGTCCCCGG -> CAGTCCCCGGG
TCAGTTGAGCC -> CAGTTGAGCCC
TCATACGAGAA -> CATACGAGAAA
TCATAGTATTG -> CATAGTATTGA
TCATCCACCCA -> CATCCACCCAT
TCATGGACCAC -> CATGGACCACC
TCATTGTTGAC -> CATTGTTGACA
TCCAAAATTAC -> CCAAAATTACC
TCCAACCGATA -> CCAACCGATAA
TCCAAGTGCTT -> CCAAGTGCTTA
TCCACCCAAGC -> CCACCCAAGCC
TCCACCCATTC -> CCACCCATTCG
TCCAGGCCCGC -> CCAGGCCCGCA
TCCAGTTGGGG -> CCAGTTGGGGG
TCCATAAAGGC -> CCATAAAGGCA
TCCATCACGAC -> CCATCACGACC
TCCATTCCTCT -> CCATTCCTCTC
TCCCAACGCTG -> CCCAACGCTGG
TCCCCACCTGA -> CCCCACCTGAA
TCCCCGGGGGT -> CCCCGGGGGTC
TCCCCTCTGCC -> CCCCTCTGCCG
TCCCGAGTGAC -> CCCGAGTGACG
TCCCTTAGAAG -> CCCTTAGAAGC
TCCGACGACTG -> CCGACGACTGG
TCCGACTCATA -> CCGACTCATAG
TCCGATACGCC -> CCGATACGCCG
TCCGCCAGTAT -> CCGCCAGTATT
TCCGCCATATG -> CCGCCATATGT
TCCGCCCGCGC -> CCGCCCGCGCG
TCCGGAGTTAG -> CCGGAGTTAGA
TCCGGGATGTA -> CCGGGATGTAA
TCCGGGGACCA -> CCGGGGACCAG
TCCGTGCAAAA -> CCGTGCAAAAC
TCCGTTCTCAG -> CCGTTCTCAGG
TCCTATAGAAG -> CCTATAGAAGG
TCCTATCGCAA -> CCTATCGCAAA
TCCTCAATAGC -> CCTCAATAGCG
TCCTCAGTCCC -> CCTCAGTCCCC
TCCTCATTGTT -> CCTCATTGTTG
TCCTCTCAGGT -> CCTCTCAGGTC
TCCTCTCTGGT -> CCTCTCTGGTT
TCCTGCGTTAT -> CCTGCGTTATC
TCCTGCTATCG -> CCTGCTATCGG
TCCTGCTGGGA -> CCTGCTGGGAA
TCCTGCTTCGC -> CCTGCTTCGCT
TCCTGTAAGTG -> CCTGTAAGTGC
TCCTTAGGTCG -> CCTTAGGTCGC
TCGAAAGGCAT -> CGAAAGGCATA
TCGAAAGTCGA -> CGAAAGTCGAA
TCGAAGAAATC -> CGAAGAAATCC
TCGAATCAGCC -> CGAATCAGCCC
TCGAGATTGAG -> CGAGATTGAGA
TCGAGTATACC -> CGAGTATACCG
TCGAGTCTTAT -> CGAGTCTTATG
TCGATCCTCAG -> CGATCCTCAGT
TCGATGCGCAA -> CGATGCGCAAG
TCGCAAAGCAA -> CGCAAAGCAAT
TCGCAGCACTA -> CGCAGCACTAA
TCGCCAACGGT -> CGCCAACGGTG
TCGCCCCCCGA -> CGCCCCCCGAG
TCGCGAAATAT -> CGCGAAATATG
TCGCGCCGTAC -> CGCGCCGTACA
TCGCTCGTGGT -> CGCTCGTGGTC
TCGCTGCGTTG -> CGCTGCGTTGA
TCGCTGGAATG -> CGCTGGAATGT
TCGCTGGTCAT -> CGCTGGTCATG
TCGGAACATCT -> CGGAACATCTG
TCGGCGGTGAG -> CGGCGGTGAGT
TCGGGATAGAT -> CGGGATAGATC
TCGGGCTGCTT -> CGGGCTGCTTT
TCGTACCTATT -> CGTACCTATTG
TCGTCAGATAT -> CGTCAGATATC
TCGTCGAGATT -> CGTCGAGATTG
TCGTCTATTGT -> CGTCTATTGTT
TCGTGGTCCGG -> CGTGGTCCGGG
TCTAAGCAACT -> CTAAGCAACTC
TCTAATGGATT -> CTAATGGATTC
TCTACGAGGTA -> CTACGAGGTAG
TCTACGGAGCA -> CTACGGAGCAC
TCTAGCGTTTA -> CTAGCGTTTAA
TCTATCGAGTC -> CTATCGAGTCT
TCTATTCGCCC -> CTATTCGCCCC
TCTATTGTTTG -> CTATTGTTTGA
TCTCAAGGCGA -> CTCAAGGCGAC
TCTCAGGACCA -> CTCAGGACCAG
TCTCAGGTCCT -> CTCAGGTCCTG
TCTCGGGATAG -> CTCGGGATAGA
TCTCTGGTTCC -> CTCTGGTTCCA
TCTGACTATAA -> CTGACTATAAG
TCTGCCCTCGT -> CTGCCCTCGTC
TCTGCCGCTGC -> CTGCCGCTGCA
TCTGGATTCCA -> CTGGATTCCAC
TCTGGTTCCAA -> CTGGTTCCAAA
TCTGTGCATGA -> CTGTGCATGAC
TCTTATGATCC -> CTTATGATCCT
TCTTCTGCCCT -> CTTCTGCCCTC
TCTTGCGAGCT -> CTTGCGAGCTT
TCTTGGAGGAG -> CTTGGAGGAGC
TCTTTTGCACT -> CTTTTGCACTC
TCTTTTTTTCC -> CTTTTTTTCCT
TGAAACATTTC -> GAAACATTTCC
TGAAATGAGGC -> GAAATGAGGCA
TGAAATGTTGA -> GAAATGTTGAC
TGAACGTTAAT -> GAACGTTAATA
TGAACTTGGTT -> GAACTTGGTTC
TGAAGGAACCG -> GAAGGAACCGT
TGAAGTACGAC -> GAAGTACGACG
TGAATCGTCTA -> GAATCGTCTAT
TGAATCTCAAG -> GAATCTCAAGG
TGACACAAGTG -> GACACAAGTGA
TGACCACGGTT -> GACCACGGTTA
TGACCGAAATG -> GACCGAAATGC
TGACCTAGGTA -> GACCTAGGTAA
TGACGCAATGC -> GACGCAATGCG
TGACTATAAGG -> GACTATAAGGG
TGACTGAAATG -> GACTGAAATGA
TGAGACCTTAT -> GAGACCTTATA
TGAGACGCCTG -> GAGACGCCTGA
TGAGCCCTTAC -> GAGCCCTTACG
TGAGGCAGAGC -> GAGGCAGAGCG
TGAGGCTACCA -> GAGGCTACCAT
TGAGGTATATG -> GAGGTATATGC
TGAGTTAAGCG -> GAGTTAAGCGA
TGAGTTGGCCA -> GAGTTGGCCAA
TGATAGTATAG -> GATAGTATAGG
TGATCAAAGTA -> GATCAAAGTAA
TGATCACACAT -> GATCACACATA
TGATCCTGTAA -> GATCCTGTAAG
TGATGGTTTCA -> GATGGTTTCAA
TGATTTTTTTT -> GATTTTTTTTC
TGCAAAACCGG -> GCAAAACCGGC
TGCAAGAAATG -> GCAAGAAATGG
TGCACACCTTT -> GCACACCTTTC
TGCACAGCAGC -> GCACAGCAGCA
TGCACCAGCTG -> GCACCAGCTGT
TGCACTCAAAC -> GCACTCAAACA
TGCACTGCAAG -> GCACTGCAAGA
TGCATAGGATC -> GCATAGGATCG
TGCATGACTGA -> GCATGACTGAA
TGCCCTCGTCA -> GCCCTCGTCAG
TGCCGACAGTG -> GCCGACAGTGA
TGCCGCTGCAC -> GCCGCTGCACA
TGCCTTTTATG -> GCCTTTTATGT
TGCGACGGAGC -> GCGACGGAGCT
TGCGAGCTTCT -> GCGAGCTTCTG
TGCGCAAGACC -> GCGCAAGACCG
TGCGGTTGGAG -> GCGGTTGGAGA
TGCGTTATCAA -> GCGTTATCAAA
TGCGTTGAGGC -> GCGTTGAGGCT
TGCTATCGGCG -> GCTATCGGCGG
TGCTCAGTTGA -> GCTCAGTTGAG
TGCTCTACGGA -> GCTCTACGGAG
TGCTGAGGTAT -> GCTGAGGTATA
TGCTGGATGAT -> GCTGGATGATT
TGCTGGGAATA -> GCTGGGAATAT
TGCTTATGTTA -> GCTTATGTTAG
TGCTTCCAGGC -> GCTTCCAGGCC
TGCTTCGCTGG -> GCTTCGCTGGA
TGCTTTGAAGT -> GCTTTGAAGTA
TGCTTTGTCTA -> GCTTTGTCTAC
TGGAATGTAGT -> GGAATGTAGTA
TGGACCACCCA -> GGACCACCCAT
TGGAGAGGTCT -> GGAGAGGTCTA
TGGAGGAGCAA -> GGAGGAGCAAG
TGGAGTCGTCG -> GGAGTCGTCGA
TGGATACAGTC -> GGATACAGTCG
TGGATGATTTT -> GGATGATTTTT
TGGATTCCACC -> GGATTCCACCC
TGGATTCCGTG -> GGATTCCGTGC
TGGCCAATAGA -> GGCCAATAGAG
TGGCGGTAGAT -> GGCGGTAGATA
TGGGAATATAG -> GGGAATATAGA
TGGGACCCCCA -> GGGACCCCCAG
TGGGCAATCCA -> GGGCAATCCAA
TGGGGACCCAT -> GGGGACCCATC
TGGGGGAGTCA -> GGGGGAGTCAT
TGGGTGAATCT -> GGGTGAATCTC
TGGTAAAAAGA -> GGTAAAAAGAT
TGGTATTTCAG -> GGTATTTCAGC
TGGTCATGGAC -> GGTCATGGACC
TGGTCCGGGGA -> GGTCCGGGGAC
TGGTCCTATAG -> GGTCCTATAGA
TGGTTACCGTT -> GGTTACCGTTT
TGGTTCCAAAA -> GGTTCCAAAAT
TGGTTCCCGAG -> GGTTCCCGAGT
TGGTTCCGTTC -> GGTTCCGTTCT
TGGTTGTCCAT -> GGTTGTCCATC
TGGTTTACCGG -> GGTTTACCGGA
TGGTTTCAATG -> GGTTTCAATGT
TGTAACCCGGT -> GTAACCCGGTT
TGTAAGTGCAC -> GTAAGTGCACC
TGTAGCCTCGA -> GTAGCCTCGAA
TGTAGTAAGAC -> GTAGTAAGACC
TGTCCAACCGA -> GTCCAACCGAT
TGTCCATCACG -> GTCCATCACGA
TGTCCCAACGC -> GTCCCAACGCT
TGTCCGGGATG -> GTCCGGGATGT
TGTCCTTAGGT -> GTCCTTAGGTC
TGTCTACGAGG -> GTCTACGAGGT
TGTGCATGACT -> GTGCATGACTG
TGTGCTTCCAG -> GTGCTTCCAGG
TGTGTCCCAAC -> GTGTCCCAACG
TGTGTTAGATT -> GTGTTAGATTA
TGTTAGATATG -> GTTAGATATGG
TGTTAGATTAG -> GTTAGATTAGT
TGTTCTTTTTT -> GTTCTTTTTTT
TGTTGACACAA -> GTTGACACAAG
TGTTGACCTAG -> GTTGACCTAGG
TGTTTGAACTT -> GTTTGAACTTG
TGTTTTTACCG -> GTTTTTACCGT
TTAAAACCCGG -> TAAAACCCGGG
TTAAACCCTTC -> TAAACCCTTCC
TTAAAGACTTT -> TAAAGACTTTA
TTAACCAGGGG -> TAACCAGGGGC
TTAACGTTTCA -> TAACGTTTCAC
TTAACTGGGAC -> TAACTGGGACC
TTAAGCGATGG -> TAAGCGATGGT
TTACCGGATCC -> TACCGGATCCC
TTACCGTCTAT -> TACCGTCTATC
TTACCGTTTGT -> TACCGTTTGTG
TTACCTGGTTT -> TACCTGGTTTA
TTACGATCCTG -> TACGATCCTGC
TTACGCTGTGT -> TACGCTGTGTT
TTACTAAGATA -> TACTAAGATAA
TTAGAAGCGTG -> TAGAAGCGTGA
TTAGAATACAG -> TAGAATACAGA
TTAGATATGGT -> TAGATATGGTT
TTAGATTAGTA -> TAGATTAGTAC
TTAGCACTAGA -> TAGCACTAGAG
TTAGGAGCGAG -> TAGGAGCGAGG
TTAGGTCGCGA -> TAGGTCGCGAA
TTAGGTTTCCG -> TAGGTTTCCGG
TTAGTACGCCT -> TAGTACGCCTA
TTATAGAACCG -> TATAGAACCGT
TTATAGAGGTC -> TATAGAGGTCC
TTATAGCTACA -> TATAGCTACAT
TTATCAAAGCT -> TATCAAAGCTT
TTATCCCCACC -> TATCCCCACCT
TTATGATCCTG -> TATGATCCTGT
TTATGCTTTGT -> TATGCTTTGTC
TTATGTTAGAT -> TATGTTAGATA
TTATGTTTTTA -> TATGTTTTTAC
TTATTAGGAGC -> TATTAGGAGCG
TTCAATGTGTC -> TCAATGTGTCC
TTCACGTCACA -> TCACGTCACAT
TTCACGTTGCC -> TCACGTTGCCT
TTCACGTTTAG -> TCACGTTTAGC
TTCACTCCTAT -> TCACTCCTATC
TTCAGAAGCCA -> TCAGAAGCCAA
TTCAGCGGTTC -> TCAGCGGTTCC
TTCCAAAATTA -> TCCAAAATTAC
TTCCACCCAAG -> TCCACCCAAGC
TTCCAGGCCCG -> TCCAGGCCCGC
TTCCAGTTGGG -> TCCAGTTGGGG
TTCCCGAGTGA -> TCCCGAGTGAC
TTCCGCCAGTA -> TCCGCCAGTAT
TTCCGGAGTTA -> TCCGGAGTTAG
TTCCGTGCAAA -> TCCGTGCAAAA
TTCCGTTCTCA -> TCCGTTCTCAG
TTCCTCATTGT -> TCCTCATTGTT
TTCCTCTCAGG -> TCCTCTCAGGT
TTCCTCTCTGG -> TCCTCTCTGGT
TTCCTGCTGGG -> TCCTGCTGGGA
TTCGATGCGCA -> TCGATGCGCAA
TTCGCAGCACT -> TCGCAGCACTA
TTCGCCCCCCG -> TCGCCCCCCGA
TTCGCTCGTGG -> TCGCTCGTGGT
TTCGCTGGAAT -> TCGCTGGAATG
TTCGGAACATC -> TCGGAACATCT
TTCTCAGGACC -> TCTCAGGACCA
TTCTGCCCTCG -> TCTGCCCTCGT
TTCTGTGCATG -> TCTGTGCATGA
TTCTTGGAGGA -> TCTTGGAGGAG
TTCTTTTTTTC -> TCTTTTTTTCC
TTGAAACATTT -> TGAAACATTTC
TTGAACTTGGT -> TGAACTTGGTT
TTGAAGTACGA -> TGAAGTACGAC
TTGAATCGTCT -> TGAATCGTCTA
TTGACACAAGT -> TGACACAAGTG
TTGACCTAGGT -> TGACCTAGGTA
TTGAGACCTTA -> TGAGACCTTAT
TTGAGCCCTTA -> TGAGCCCTTAC
TTGAGGCTACC -> TGAGGCTACCA
TTGATCAAAGT -> TGATCAAAGTA
TTGCACTCAAA -> TGCACTCAAAC
TTGCCTTTTAT -> TGCCTTTTATG
TTGCGAGCTTC -> TGCGAGCTTCT
TTGCTCAGTTG -> TGCTCAGTTGA
TTGGAGAGGTC -> TGGAGAGGTCT
TTGGAGGAGCA -> TGGAGGAGCAA
TTGGCCAATAG -> TGGCCAATAGA
TTGGGGGAGTC -> TGGGGGAGTCA
TTGGTATTTCA -> TGGTATTTCAG
TTGGTTCCGTT -> TGGTTCCGTTC
TTGTCCATCAC -> TGTCCATCACG
TTGTCTACGAG -> TGTCTACGAGG
TTGTGCTTCCA -> TGTGCTTCCAG
TTGTTGACACA -> TGTTGACACAA
TTGTTTGAACT -> TGTTTGAACTT
TTTAAAACCCG -> TTAAAACCCGG
TTTAAACCCTT -> TTAAACCCTTC
TTTACCGGATC -> TTACCGGATCC
TTTACCGTCTA -> TTACCGTCTAT
TTTACTAAGAT -> TTACTAAGATA
TTTAGCACTAG -> TTAGCACTAGA
TTTAGGTTTCC -> TTAGGTTTCCG
TTTATAGAACC -> TTATAGAACCG
TTTATGTTTTT -> TTATGTTTTTA
TTTCAATGTGT -> TTCAATGTGTC
TTTCACGTTTA -> TTCACGTTTAG
TTTCACTCCTA -> TTCACTCCTAT
TTTCAGAAGCC -> TTCAGAAGCCA
TTTCAGCGGTT -> TTCAGCGGTTC
TTTCCGCCAGT -> TTCCGCCAGTA
TTTCCGGAGTT -> TTCCGGAGTTA
TTTCCTCATTG -> TTCCTCATTGT
TTTCCTCTCAG -> TTCCTCTCAGG
TTTCGCAGCAC -> TTCGCAGCACT
TTTCGCTCGTG -> TTCGCTCGTGG
TTTCTTGGAGG -> TTCTTGGAGGA
TTTGAACTTGG -> TTGAACTTGGT
TTTGAAGTACG -> TTGAAGTACGA
TTTGCACTCAA -> TTGCACTCAAA
TTTGTCTACGA -> TTGTCTACGAG
TTTGTGCTTCC -> TTGTGCTTCCA
TTTTACCGTCT -> TTTACCGTCTA
TTTTATAGAAC -> TTTATAGAACC
TTTTATGTTTT -> TTTATGTTTTT
TTTTCAGAAGC -> TTTCAGAAGCC
TTTTCCTCTCA -> TTTCCTCTCAG
TTTTCTTGGAG -> TTTCTTGGAGG
TTTTGCACTCA -> TTTGCACTCAA
TTTTTACCGTC -> TTTTACCGTCT
TTTTTATAGAA -> TTTTATAGAAC
TTTTTCAGAAG -> TTTTCAGAAGC
TTTTTCCTCTC -> TTTTCCTCTCA
TTTTTTCAGAA -> TTTTTCAGAAG
TTTTTTCCTCT -> TTTTTCCTCTC
TTTTTTTCAGA -> TTTTTTCAGAA
TTTTTTTCCTC -> TTTTTTCCTCT
TTTTTTTTCAG -> TTTTTTTCAGA
